a	a
abartılı	abaɾtɯlɯ
abi	abi
aç	at͡ʃ
açalım	at͡ʃalɯm
açan	at͡ʃan
açar	at͡ʃaɾ
acele	ad͡ʒele
açgözlülük	at͡ʃɡœzlylyk
açmamışım	at͡ʃmamɯʃɯm
açmayı	at͡ʃmajɯ
açmış	at͡ʃmɯʃ
açmıştı	at͡ʃmɯʃtɯ
açtırıp	at͡ʃtɯɾɯp
acı	ad͡ʒɯ
açıcı	at͡ʃɯd͡ʒɯ
açıcıydı	at͡ʃɯd͡ʒɯjdɯ
açık	at͡ʃɯk
açıkladı	at͡ʃɯkladɯ
açıklama	at͡ʃɯklama
açıklamalar	at͡ʃɯklamalaɾ
açıklamalarda	at͡ʃɯklamalaɾda
açıklamalarla	at͡ʃɯklamalaɾla
açıklamanın	at͡ʃɯklamanɯn
açıklaması	at͡ʃɯklamasɯ
açıklayan	at͡ʃɯklajan
açıklık	at͡ʃɯklɯk
acıkmamışım	ad͡ʒɯkmamɯʃɯm
açılan	at͡ʃɯlan
açılardan	at͡ʃɯlaɾdan
acılarla	ad͡ʒɯlaɾla
açılmasını	at͡ʃɯlmasɯnɯ
açılmasının	at͡ʃɯlmasɯnɯn
açılmış	at͡ʃɯlmɯʃ
açılışına	at͡ʃɯlɯʃɯna
acımasızca	ad͡ʒɯmasɯzd͡ʒa
acınacak	ad͡ʒɯnad͡ʒak
açıp	at͡ʃɯp
acısından	ad͡ʒɯsɯndan
açısından	at͡ʃɯsɯndan
açıyorsun	at͡ʃɯjoɾsun
açığı	at͡ʃɯɰɯ
adaletli	adaletli
adam	adam
adama	adama
adamları	adamlaɾɯ
adamların	adamlaɾɯn
adamı	adamɯ
adamımız	adamɯmɯz
adamın	adamɯn
adasına	adasɯna
aday	adaj
adayan	adajan
adayı	adajɯ
addidif	addidif
adet	adet
âdeta	âdeta
adi	adi
adlarını	adlaɾɯnɯ
adlı	adlɯ
adresinde	adɾesinde
adresindeki	adɾesindeki
adı	adɯ
adımlarını	adɯmlaɾɯnɯ
adına	adɯna
adında	adɯnda
adını	adɯnɯ
adının	adɯnɯn
adıyla	adɯjla
afaki	afaki
affedebilecek	affedebiled͡ʒek
afiyet	afijet
ahali	ahali
ahbaz	ahbaz
ahlaka	ahlaka
ahşap	ahʃap
aile	aile
aileler	aileleɾ
ailelere	aileleɾe
ailenin	ailenin
aileyi	aileji
ait	ait
akabinde	akabinde
akan	akan
akciğerlerine	akd͡ʒiɰeɾleɾine
aklı	aklɯ
aklıma	aklɯma
aklımda	aklɯmda
aklımdan	aklɯmdan
aklımız	aklɯmɯz
aklına	aklɯna
aklınızda	aklɯnɯzda
aktararak	aktaɾaɾak
aktardı	aktaɾdɯ
aktif	aktif
akü	aky
akşam	akʃam
akşamlan	akʃamlan
akşamları	akʃamlaɾɯ
akıl	akɯl
akıldışı	akɯldɯʃɯ
akımı	akɯmɯ
akıyorduk	akɯjoɾduk
alabilecekler	alabiled͡ʒekleɾ
alabileceklerdir	alabiled͡ʒekleɾdiɾ
alabiliyor	alabilijoɾ
alacak	alad͡ʒak
alacaktım	alad͡ʒaktɯm
alan	alan
alanda	alanda
alarak	alaɾak
alaylı	alajlɯ
alayı	alajɯ
albüm	albym
aldı	aldɯ
aldık	aldɯk
aldıklarını	aldɯklaɾɯnɯ
aldım	aldɯm
aldırdıkları	aldɯɾdɯklaɾɯ
aldırış	aldɯɾɯʃ
aldığı	aldɯɰɯ
aldığım	aldɯɰɯm
aldığınız	aldɯɰɯnɯz
aldığınızda	aldɯɰɯnɯzda
alelacele	alelad͡ʒele
alemdir	alemdiɾ
âlemine	âlemine
âletin	âletin
aleve	aleve
aleyhimde	alejhimde
aleyhine	alejhine
aleyhisselam	alejhisselam
algılanacaktır	alɡɯlanad͡ʒaktɯɾ
almak	almak
almaktan	almaktan
almalı	almalɯ
almamazlık	almamazlɯk
almamla	almamla
almaz	almaz
almıyor	almɯjoɾ
almış	almɯʃ
almıştı	almɯʃtɯ
almıştır	almɯʃtɯɾ
alt	alt
altı	altɯ
altın	altɯn
altına	altɯna
altında	altɯnda
altını	altɯnɯ
alıcılarını	alɯd͡ʒɯlaɾɯnɯ
alın	alɯn
alınacak	alɯnad͡ʒak
alınan	alɯnan
alınarak	alɯnaɾak
alındı	alɯndɯ
alındığını	alɯndɯɰɯnɯ
alınması	alɯnmasɯ
alınır	alɯnɯɾ
alınıyor	alɯnɯjoɾ
alıp	alɯp
alır	alɯɾ
alırız	alɯɾɯz
alıyor	alɯjoɾ
alıyordu	alɯjoɾdu
alıştırılmaları	alɯʃtɯɾɯlmalaɾɯ
alışınca	alɯʃɯnd͡ʒa
ama	ama
amaç	amat͡ʃ
amaçlamaktadır	amat͡ʃlamaktadɯɾ
amaçlı	amat͡ʃlɯ
amaçtır	amat͡ʃtɯɾ
amacı	amad͡ʒɯ
amacıyla	amad͡ʒɯjla
ambargonun	ambaɾɡonun
amca	amd͡ʒa
âmirim	âmiɾim
amortisman	amoɾtisman
an	an
ana	ana
anacığına	anad͡ʒɯɰɯna
analizlerin	analizleɾin
anavatanı	anavatanɯ
anayasal	anajasal
ancak	and͡ʒak
and	and
anda	anda
andan	andan
andıran	andɯɾan
aniden	aniden
anladım	anladɯm
anlam	anlam
anlamak	anlamak
anlamı	anlamɯ
anlamına	anlamɯna
anlamış	anlamɯʃ
anlat	anlat
anlatmak	anlatmak
anlatması	anlatmasɯ
anlatmaya	anlatmaja
anlattığı	anlattɯɰɯ
anlatıcı	anlatɯd͡ʒɯ
anlatılan	anlatɯlan
anlatılırdı	anlatɯlɯɾdɯ
anlatım	anlatɯm
anlatır	anlatɯɾ
anlatıyor	anlatɯjoɾ
anlatıyordu	anlatɯjoɾdu
anlayacak	anlajad͡ʒak
anlayamazsınız	anlajamazsɯnɯz
anlayan	anlajan
anlayıp	anlajɯp
anlayış	anlajɯʃ
anlayışlı	anlajɯʃlɯ
anlayışının	anlajɯʃɯnɯn
anlaşmalarının	anlaʃmalaɾɯnɯn
anlaşmış	anlaʃmɯʃ
anlaşmıştır	anlaʃmɯʃtɯɾ
anne	anne
annelerinin	anneleɾinin
anneme	anneme
annenin	annenin
annesinin	annesinin
ansiklopedisini	ansiklopedisini
anılan	anɯlan
anılarından	anɯlaɾɯndan
anında	anɯnda
anısına	anɯsɯna
apartmanlar	apaɾtmanlaɾ
ara	aɾa
araba	aɾaba
arabalar	aɾabalaɾ
arabalardır	aɾabalaɾdɯɾ
arabama	aɾabama
arabasıyla	aɾabasɯjla
arabayla	aɾabajla
araç	aɾat͡ʃ
araçlarıyla	aɾat͡ʃlaɾɯjla
araçta	aɾat͡ʃta
aracı	aɾad͡ʒɯ
aracılıyla	aɾad͡ʒɯlɯjla
aracını	aɾad͡ʒɯnɯ
arada	aɾada
aradaki	aɾadaki
aralarında	aɾalaɾɯnda
aramadın	aɾamadɯn
aramaktan	aɾamaktan
araması	aɾamasɯ
aranızdaki	aɾanɯzdaki
arap	aɾap
arar	aɾaɾ
arardım	aɾaɾdɯm
ararken	aɾaɾken
arası	aɾasɯ
arasına	aɾasɯna
arasında	aɾasɯnda
arasındaki	aɾasɯndaki
arasından	aɾasɯndan
araya	aɾaja
arayacağız	aɾajad͡ʒaɰɯz
arayışlar	aɾajɯʃlaɾ
arayışından	aɾajɯʃɯndan
arayışını	aɾajɯʃɯnɯ
araştırma	aɾaʃtɯɾma
araştırmacı	aɾaʃtɯɾmad͡ʒɯ
araştırmanın	aɾaʃtɯɾmanɯn
ardında	aɾdɯnda
ardından	aɾdɯndan
arkada	aɾkada
arkadaş	aɾkadaʃ
arkadaşlar	aɾkadaʃlaɾ
arkadaşlarla	aɾkadaʃlaɾla
arkadaşları	aɾkadaʃlaɾɯ
arkadaşlarıma	aɾkadaʃlaɾɯma
arkadaşlarımı	aɾkadaʃlaɾɯmɯ
arkadaşlarımız	aɾkadaʃlaɾɯmɯz
arkadaşların	aɾkadaʃlaɾɯn
arkadaşlarınla	aɾkadaʃlaɾɯnla
arkadaşlarını	aɾkadaʃlaɾɯnɯ
arkadaşlarınızla	aɾkadaʃlaɾɯnɯzla
arkadaşım	aɾkadaʃɯm
arkadaşımdı	aɾkadaʃɯmdɯ
arkadaşımla	aɾkadaʃɯmla
arkadaşının	aɾkadaʃɯnɯn
arkana	aɾkana
arkanda	aɾkanda
arkasında	aɾkasɯnda
arkasındaki	aɾkasɯndaki
armağan	aɾmaɰan
aromatiklere	aɾomatikleɾe
arta	aɾta
artezyen	aɾtezjen
artizler	aɾtizleɾ
arttı	aɾttɯ
arttırılabilir	aɾttɯɾɯlabiliɾ
arttığını	aɾttɯɰɯnɯ
artık	aɾtɯk
artıklarını	aɾtɯklaɾɯnɯ
artıklarının	aɾtɯklaɾɯnɯn
artırdığına	aɾtɯɾdɯɰɯna
artırdığını	aɾtɯɾdɯɰɯnɯ
artırmak	aɾtɯɾmak
artışına	aɾtɯʃɯna
arz	aɾz
arzulamaz	aɾzulamaz
arzusu	aɾzusu
arşivinden	aɾʃivinden
arınması	aɾɯnmasɯ
asansörle	asansœɾle
askeri	askeɾi
askerleri	askeɾleɾi
askerlerin	askeɾleɾin
askerlerle	askeɾleɾle
asla	asla
aslanla	aslanla
aslında	aslɯnda
asmadı	asmadɯ
asıldığını	asɯldɯɰɯnɯ
asıllı	asɯllɯ
asır	asɯɾ
at	at
atacak	atad͡ʒak
atacaktım	atad͡ʒaktɯm
atamadık	atamadɯk
atanmıştır	atanmɯʃtɯɾ
atarlar	ataɾlaɾ
atlayınca	atlajɯnd͡ʒa
atletik	atletik
atmamız	atmamɯz
atmaya	atmaja
atraksiyon	atɾaksijon
attığı	attɯɰɯ
attığımda	attɯɰɯmda
atılan	atɯlan
atılmalıdır	atɯlmalɯdɯɾ
atılmış	atɯlmɯʃ
atılmıştır	atɯlmɯʃtɯɾ
atılım	atɯlɯm
atın	atɯn
atınca	atɯnd͡ʒa
atıyor	atɯjoɾ
avantajlı	avantaʒlɯ
avuç	avut͡ʃ
ay	aj
ayakkabı	ajakkabɯ
ayaklarıma	ajaklaɾɯma
ayaklarımızın	ajaklaɾɯmɯzɯn
ayaklarını	ajaklaɾɯnɯ
ayaklarının	ajaklaɾɯnɯn
ayakta	ajakta
ayaktakiler	ajaktakileɾ
ayarlayabilirseniz	ajaɾlajabiliɾseniz
ayağa	ajaɰa
aydınlar	ajdɯnlaɾ
aydınlatıp	ajdɯnlatɯp
aydınlık	ajdɯnlɯk
aylı	ajlɯ
aylık	ajlɯk
aynı	ajnɯ
ayranla	ajɾanla
ayrı	ajɾɯ
ayrıca	ajɾɯd͡ʒa
ayrılamıyorlardı	ajɾɯlamɯjoɾlaɾdɯ
ayrıldınız	ajɾɯldɯnɯz
ayrılması	ajɾɯlmasɯ
ayrımların	ajɾɯmlaɾɯn
ayrıntılarıyla	ajɾɯntɯlaɾɯjla
ayrıntılı	ajɾɯntɯlɯ
ayın	ajɯn
ayında	ajɯnda
ayırdığını	ajɯɾdɯɰɯnɯ
ayırmaktadırlar	ajɯɾmaktadɯɾlaɾ
ayırın	ajɯɾɯn
az	az
azalma	azalma
azarlanır	azaɾlanɯɾ
azımsanmayacak	azɯmsanmajad͡ʒak
azından	azɯndan
azınlık	azɯnlɯk
ağaç	aɰat͡ʃ
ağaçlarının	aɰat͡ʃlaɾɯnɯn
ağacın	aɰad͡ʒɯn
aşamada	aʃamada
aşan	aʃan
aşağılık	aʃaɰɯlɯk
aşağıya	aʃaɰɯja
aşk	aʃk
aşkı	aʃkɯ
aşkın	aʃkɯn
aşkına	aʃkɯna
aşkını	aʃkɯnɯ
ağlatanla	aɰlatanla
aştı	aʃtɯ
ağustos	aɰustos
ağzında	aɰzɯnda
ağzından	aɰzɯndan
ağzını	aɰzɯnɯ
âşık	âʃɯk
ağır	aɰɯɾ
ağızları	aɰɯzlaɾɯ
baba	baba
babam	babam
babama	babama
babamın	babamɯn
babası	babasɯ
bahçesi	baht͡ʃesi
bahçesine	baht͡ʃesine
bahçeye	baht͡ʃeje
bahsederim	bahsedeɾim
bahsediyorum	bahsedijoɾum
bahtımı	bahtɯmɯ
bakalım	bakalɯm
bakmak	bakmak
bakmakta	bakmakta
bakmam	bakmam
baktı	baktɯ
baktığımda	baktɯɰɯmda
baktığında	baktɯɰɯnda
bakıldığında	bakɯldɯɰɯnda
bakımsız	bakɯmsɯz
bakın	bakɯn
bakınmaya	bakɯnmaja
bakıp	bakɯp
bakıyorlar	bakɯjoɾlaɾ
bakıyorlardı	bakɯjoɾlaɾdɯ
bakıyorum	bakɯjoɾum
bakış	bakɯʃ
bakışını	bakɯʃɯnɯ
bakışıp	bakɯʃɯp
bal	bal
baleden	baleden
balon	balon
balı	balɯ
balıkçı	balɯkt͡ʃɯ
balıkçılık	balɯkt͡ʃɯlɯk
bana	bana
banka	banka
bardak	baɾdak
bardağı	baɾdaɰɯ
basit	basit
baskı	baskɯ
basmamaları	basmamalaɾɯ
basmaya	basmaja
basın	basɯn
basınçlı	basɯnt͡ʃlɯ
basınından	basɯnɯndan
basıp	basɯp
battı	battɯ
bayat	bajat
baygın	bajɡɯn
bayraklarla	bajɾaklaɾla
bayram	bajɾam
bayramdır	bajɾamdɯɾ
bayramınız	bajɾamɯnɯz
bayrağımızda	bajɾaɰɯmɯzda
bayılması	bajɯlmasɯ
bazı	bazɯ
bazıları	bazɯlaɾɯ
baş	baʃ
başarılara	baʃaɾɯlaɾa
başarılı	baʃaɾɯlɯ
başarısız	baʃaɾɯsɯz
başarıyla	baʃaɾɯjla
bağda	baɰda
bağdakini	baɰdakini
bağdaşıklığını	baɰdaʃɯklɯɰɯnɯ
başka	baʃka
başkaları	baʃkalaɾɯ
başkalarına	baʃkalaɾɯna
başkaldırı	baʃkaldɯɾɯ
başkan	baʃkan
başkanı	baʃkanɯ
başkanının	baʃkanɯnɯn
başkasının	baʃkasɯnɯn
başkent	baʃkent
başkentin	baʃkentin
başladı	baʃladɯ
başladılar	baʃladɯlaɾ
başladım	baʃladɯm
başladığı	baʃladɯɰɯ
başlama	baʃlama
başlamadan	baʃlamadan
başlamak	baʃlamak
başlamaz	baʃlamaz
bağlamda	baɰlamda
bağlamış	baɰlamɯʃ
başlamış	baʃlamɯʃ
bağlandı	baɰlandɯ
başlandı	baʃlandɯ
başlangıç	baʃlanɡɯt͡ʃ
bağlanmamasından	baɰlanmamasɯndan
bağlanmamasındandır	baɰlanmamasɯndandɯɾ
başlar	baʃlaɾ
başlarlar	baʃlaɾlaɾ
bağları	baɰlaɾɯ
başlarını	baʃlaɾɯnɯ
başlarının	baʃlaɾɯnɯn
başlattığı	baʃlattɯɰɯ
başlayalım	baʃlajalɯm
başlayan	baʃlajan
başlıca	baʃlɯd͡ʒa
başlık	baʃlɯk
bağlıyor	baɰlɯjoɾ
başlıyor	baʃlɯjoɾ
başlıyorlar	baʃlɯjoɾlaɾ
başlıyorlarmış	baʃlɯjoɾlaɾmɯʃ
başlıyorsunuz	baʃlɯjoɾsunuz
başörtülü	baʃœɾtyly
başrollerden	baʃɾolleɾden
başta	baʃta
başvurusu	baʃvuɾusu
başı	baʃɯ
başım	baʃɯm
başımda	baʃɯmda
bağımlılığı	baɰɯmlɯlɯɰɯ
bağımsızlık	baɰɯmsɯzlɯk
başımızı	baʃɯmɯzɯ
bağın	baɰɯn
başına	baʃɯna
başında	baʃɯnda
başını	baʃɯnɯ
bağırmaya	baɰɯɾmaja
bağışladılar	baɰɯʃladɯlaɾ
be	be
bebek	bebek
bebekler	bebekleɾ
bebekti	bebekti
beceriksizliklerinin	bed͡ʒeɾiksizlikleɾinin
bedel	bedel
bedeli	bedeli
bedelleri	bedelleɾi
beden	beden
bekâr	bekâɾ
beklediğim	beklediɰim
beklenir	bekleniɾ
bekleniyordu	beklenijoɾdu
bekleyen	beklejen
belden	belden
belediyelerin	beledijeleɾin
belgeler	belɡeleɾ
beline	beline
belirginleşti	beliɾɡinleʃti
belirlediği	beliɾlediɰi
belirlenirken	beliɾleniɾken
belirlenmesinde	beliɾlenmesinde
belirleyici	beliɾlejid͡ʒi
belirsiz	beliɾsiz
belirten	beliɾten
belirtilir	beliɾtiliɾ
belirtiliyor	beliɾtilijoɾ
belirtirken	beliɾtiɾken
belirtmek	beliɾtmek
belirtti	beliɾtti
belirttiler	beliɾttileɾ
belirttim	beliɾttim
belki	belki
belli	belli
belliydi	bellijdi
bemol	bemol
ben	ben
bence	bend͡ʒe
bende	bende
beni	beni
benim	benim
benimsediğim	benimsediɰim
benimsenmiş	benimsenmiʃ
benimsenmiştir	benimsenmiʃtiɾ
benlik	benlik
benliğine	benliɰine
bensiz	bensiz
benzer	benzeɾ
benzetir	benzetiɾ
benzetmez	benzetmez
benzeşme	benzeʃme
benziyorlar	benzijoɾlaɾ
beraber	beɾabeɾ
beraberlik	beɾabeɾlik
beri	beɾi
besiçlerin	besit͡ʃleɾin
besin	besin
besinleri	besinleɾi
beste	beste
betimleri	betimleɾi
beyaz	bejaz
beygir	bejɡiɾ
beyni	bejni
bezdirerek	bezdiɾeɾek
beş	beʃ
beğenir	beɰeniɾ
beğenirse	beɰeniɾse
bi	bi
biber	bibeɾ
biberleri	bibeɾleɾi
biblo	biblo
bibloymuş	biblojmuʃ
biçimde	bit͡ʃimde
biçimlerde	bit͡ʃimleɾde
biçimlerine	bit͡ʃimleɾine
bifteğin	bifteɰin
bildik	bildik
bildirdi	bildiɾdi
bildirildiğinde	bildiɾildiɰinde
bildiriyle	bildiɾijle
bildiğinden	bildiɰinden
bile	bile
bilemez	bilemez
bilen	bilen
bilet	bilet
bileydin	bilejdin
bilgi	bilɡi
bilgidir	bilɡidiɾ
bilgiler	bilɡileɾ
bilgilere	bilɡileɾe
bilgileri	bilɡileɾi
bilgilerin	bilɡileɾin
bilgilerini	bilɡileɾini
bilginin	bilɡinin
bilgisayar	bilɡisajaɾ
bilgisayarlarda	bilɡisajaɾlaɾda
bilgisi	bilɡisi
bilgisini	bilɡisini
bilim	bilim
bilimin	bilimin
bilimsel	bilimsel
bilinmektedir	bilinmektediɾ
bilinmeyen	bilinmejen
bilinmez	bilinmez
bilirdi	biliɾdi
bilirdiniz	biliɾdiniz
bilirim	biliɾim
bilirkişilik	biliɾkiʃilik
biliyorlar	bilijoɾlaɾ
biliyorum	bilijoɾum
biliyoruz	bilijoɾuz
bilmem	bilmem
bilmiyorum	bilmijoɾum
bilmiyoruz	bilmijoɾuz
bin	bin
binayı	binajɯ
binden	binden
bindim	bindim
bindirmeli	bindiɾmeli
bine	bine
binip	binip
binlerce	binleɾd͡ʒe
bir	biɾ
biraz	biɾaz
birazcık	biɾazd͡ʒɯk
birbiri	biɾbiɾi
birbirinin	biɾbiɾinin
birbirlerine	biɾbiɾleɾine
birbirlerini	biɾbiɾleɾini
birçok	biɾt͡ʃok
birçokları	biɾt͡ʃoklaɾɯ
birden	biɾden
birdenbire	biɾdenbiɾe
birer	biɾeɾ
biri	biɾi
birikimi	biɾikimi
birikmesini	biɾikmesini
birim	biɾim
birinci	biɾind͡ʒi
birinde	biɾinde
birini	biɾini
birinin	biɾinin
biriydi	biɾijdi
biriyle	biɾijle
birkaç	biɾkat͡ʃ
birleştirerek	biɾleʃtiɾeɾek
birlik	biɾlik
birlikte	biɾlikte
birlikteliğin	biɾlikteliɰin
birliği	biɾliɰi
birtakım	biɾtakɯm
birşeyler	biɾʃejleɾ
bisiklet	bisiklet
bitecek	bited͡ʒek
bitenlere	bitenleɾe
biterken	biteɾken
bitirdikten	bitiɾdikten
bitirenler	bitiɾenleɾ
bitirmiş	bitiɾmiʃ
bitiyor	bitijoɾ
bitişi	bitiʃi
bitki	bitki
bitmedi	bitmedi
bitmemesini	bitmemesini
bitmesi	bitmesi
bittiğinde	bittiɰinde
biyoyakıt	bijojakɯt
bize	bize
bizi	bizi
bizim	bizim
bizimle	bizimle
bizleri	bizleɾi
bloke	bloke
böbrek	bœbɾek
böceğinin	bœd͡ʒeɰinin
bölge	bœlɡe
bölgeciliğin	bœlɡed͡ʒiliɰin
bölgelere	bœlɡeleɾe
bölgesel	bœlɡesel
bölgeye	bœlɡeje
bölmeleri	bœlmeleɾi
bölüm	bœlym
bölümde	bœlymde
bölümlemeler	bœlymlemeleɾ
bölümlere	bœlymleɾe
bölümünde	bœlymynde
bölümünün	bœlymynyn
bölüğü	bœlyɰy
bomba	bomba
bombardımanında	bombaɾdɯmanɯnda
bombası	bombasɯ
borçlarını	boɾt͡ʃlaɾɯnɯ
borcu	boɾd͡ʒu
boru	boɾu
borusunu	boɾusunu
botokslanmamış	botokslanmamɯʃ
boy	boj
boyalardan	bojalaɾdan
boyayan	bojajan
böyle	bœjle
böyleyken	bœjlejken
boynumuza	bojnumuza
boyu	boju
boyunca	bojund͡ʒa
boyunda	bojunda
boyut	bojut
boyutları	bojutlaɾɯ
boyutta	bojutta
boyutu	bojutu
bozacağım	bozad͡ʒaɰɯm
bozar	bozaɾ
bozma	bozma
bozmadığını	bozmadɯɰɯnɯ
bozucu	bozud͡ʒu
bozuk	bozuk
boş	boʃ
boğazına	boɰazɯna
boğdular	boɰdulaɾ
boğulabilir	boɰulabiliɾ
briç	bɾit͡ʃ
bu	bu
buçuk	but͡ʃuk
büfe	byfe
bugün	buɡyn
bugünkü	buɡynky
buharlaşır	buhaɾlaʃɯɾ
buharı	buhaɾɯ
buharının	buhaɾɯnɯn
bükülmeden	bykylmeden
bükülür	bykylyɾ
bulamadılar	bulamadɯlaɾ
bulamayınca	bulamajɯnd͡ʒa
bulan	bulan
bulana	bulana
bularak	bulaɾak
bulaştığı	bulaʃtɯɰɯ
buldum	buldum
buldunuz	buldunuz
bulduğu	bulduɰu
bulma	bulma
bulmaya	bulmaja
bulun	bulun
bulunabilir	bulunabiliɾ
bulunacak	bulunad͡ʒak
bulunan	bulunan
bulunca	bulund͡ʒa
bulundu	bulundu
bulundurmakla	bulunduɾmakla
bulunduğu	bulunduɰu
bulunmadığı	bulunmadɯɰɯ
bulunmak	bulunmak
bulunmaktadır	bulunmaktadɯɾ
bulunmuş	bulunmuʃ
bulunur	bulunuɾ
bulunurken	bulunuɾken
bulunuyordu	bulunujoɾdu
bulup	bulup
buluruz	buluɾuz
bulutları	bulutlaɾɯ
buluşabilirsiniz	buluʃabiliɾsiniz
buluşana	buluʃana
buluşmuş	buluʃmuʃ
buluştu	buluʃtu
buluşun	buluʃun
buluşup	buluʃup
buna	buna
bunca	bund͡ʒa
bunda	bunda
bundan	bundan
bunlar	bunlaɾ
bunlara	bunlaɾa
bunlardan	bunlaɾdan
bunları	bunlaɾɯ
bunların	bunlaɾɯn
bunu	bunu
bunun	bunun
bünyesinde	bynjesinde
burada	buɾada
buradan	buɾadan
buralarda	buɾalaɾda
buraya	buɾaja
burcun	buɾd͡ʒun
burcunda	buɾd͡ʒunda
burcunun	buɾd͡ʒunun
burcunuz	buɾd͡ʒunuz
büroda	byɾoda
bürokrasiyi	byɾokɾasiji
bürosunu	byɾosunu
büründü	byɾyndy
büründürülmedi	byɾyndyɾylmedi
bütçe	bytt͡ʃe
bütün	bytyn
bütünüyle	bytynyjle
büyüdü	byjydy
büyüdüğünü	byjydyɰyny
büyük	byjyk
büyüktür	byjyktyɾ
büyümeye	byjymeje
büyüsü	byjysy
büyüyen	byjyjen
büyüğü	byjyɰy
bıkmış	bɯkmɯʃ
bıkmıştı	bɯkmɯʃtɯ
bırakacak	bɯɾakad͡ʒak
bırakan	bɯɾakan
bırakmışlar	bɯɾakmɯʃlaɾ
bırakmışlardı	bɯɾakmɯʃlaɾdɯ
bıraktıklarını	bɯɾaktɯklaɾɯnɯ
bıraktım	bɯɾaktɯm
bırakılmalıdır	bɯɾakɯlmalɯdɯɾ
bırakılmasını	bɯɾakɯlmasɯnɯ
çaba	t͡ʃaba
çabalar	t͡ʃabalaɾ
çabaları	t͡ʃabalaɾɯ
çabaların	t͡ʃabalaɾɯn
çabayı	t͡ʃabajɯ
çabucak	t͡ʃabud͡ʒak
cadde	d͡ʒadde
caddelerde	d͡ʒaddeleɾde
caddenin	d͡ʒaddenin
çadırı	t͡ʃadɯɾɯ
çalacak	t͡ʃalad͡ʒak
çalacaktı	t͡ʃalad͡ʒaktɯ
çalı	t͡ʃalɯ
çalılıklar	t͡ʃalɯlɯklaɾ
çalıntı	t͡ʃalɯntɯ
çalışabilmesi	t͡ʃalɯʃabilmesi
çalışabilmesine	t͡ʃalɯʃabilmesine
çalışacak	t͡ʃalɯʃad͡ʒak
çalışan	t͡ʃalɯʃan
çalışanları	t͡ʃalɯʃanlaɾɯ
çalışma	t͡ʃalɯʃma
çalışmak	t͡ʃalɯʃmak
çalışmaları	t͡ʃalɯʃmalaɾɯ
çalışmalarına	t͡ʃalɯʃmalaɾɯna
çalışmasını	t͡ʃalɯʃmasɯnɯ
çalışmasının	t͡ʃalɯʃmasɯnɯn
çalışmaya	t͡ʃalɯʃmaja
çalışmıyor	t͡ʃalɯʃmɯjoɾ
çalıştığı	t͡ʃalɯʃtɯɰɯ
çalışılmalı	t͡ʃalɯʃɯlmalɯ
çalışılması	t͡ʃalɯʃɯlmasɯ
çalışılıyor	t͡ʃalɯʃɯlɯjoɾ
çalışınca	t͡ʃalɯʃɯnd͡ʒa
çalışırken	t͡ʃalɯʃɯɾken
çalışıyor	t͡ʃalɯʃɯjoɾ
çalışıyordu	t͡ʃalɯʃɯjoɾdu
çalışıyoruz	t͡ʃalɯʃɯjoɾuz
camiye	d͡ʒamije
çamur	t͡ʃamuɾ
canlandırmak	d͡ʒanlandɯɾmak
canlı	d͡ʒanlɯ
canı	d͡ʒanɯ
çapalar	t͡ʃapalaɾ
care	d͡ʒaɾe
cari	d͡ʒaɾi
çarpıtıyorlar	t͡ʃaɾpɯtɯjoɾlaɾ
çarpıyor	t͡ʃaɾpɯjoɾ
çarpışarak	t͡ʃaɾpɯʃaɾak
casusluk	d͡ʒasusluk
çatı	t͡ʃatɯ
çatışma	t͡ʃatɯʃma
çavdar	t͡ʃavdaɾ
çavdarlı	t͡ʃavdaɾlɯ
çay	t͡ʃaj
çaycı	t͡ʃajd͡ʒɯ
caz	d͡ʒaz
çağda	t͡ʃaɰda
çağdan	t͡ʃaɰdan
çağdaş	t͡ʃaɰdaʃ
çağrı	t͡ʃaɰɾɯ
çağrısı	t͡ʃaɰɾɯsɯ
çağrısına	t͡ʃaɰɾɯsɯna
çağrışımlar	t͡ʃaɰɾɯʃɯmlaɾ
çağında	t͡ʃaɰɯnda
çağındaki	t͡ʃaɰɯndaki
çağırana	t͡ʃaɰɯɾana
çağırmayı	t͡ʃaɰɯɾmajɯ
çağırıp	t͡ʃaɰɯɾɯp
çağırıyordu	t͡ʃaɰɯɾɯjoɾdu
çehresiyle	t͡ʃehɾesijle
çekeceğini	t͡ʃeked͡ʒeɰini
ceketi	d͡ʒeketi
çekiçli	t͡ʃekit͡ʃli
çekildi	t͡ʃekildi
çekilir	t͡ʃekiliɾ
çekiliyor	t͡ʃekilijoɾ
çekilmez	t͡ʃekilmez
çekim	t͡ʃekim
çekin	t͡ʃekin
çekiyordum	t͡ʃekijoɾdum
çekmeye	t͡ʃekmeje
çekmiş	t͡ʃekmiʃ
çekmiştir	t͡ʃekmiʃtiɾ
çelik	t͡ʃelik
çelişen	t͡ʃeliʃen
çelişki	t͡ʃeliʃki
cennet	d͡ʒennet
çerçevesi	t͡ʃeɾt͡ʃevesi
çerçevesinde	t͡ʃeɾt͡ʃevesinde
çerkez	t͡ʃeɾkez
cesedimi	d͡ʒesedimi
cesedini	d͡ʒesedini
cesetleri	d͡ʒesetleɾi
cesetlerin	d͡ʒesetleɾin
cevabı	d͡ʒevabɯ
cevap	d͡ʒevap
çevirdi	t͡ʃeviɾdi
ceviz	d͡ʒeviz
çevrede	t͡ʃevɾede
çevresinde	t͡ʃevɾesinde
çevrili	t͡ʃevɾili
çevriliymiş	t͡ʃevɾilijmiʃ
cezaevinden	d͡ʒezaevinden
cezasına	d͡ʒezasɯna
çeşitli	t͡ʃeʃitli
çeşme	t͡ʃeʃme
chatin	d͡ʒhatin
çiçek	t͡ʃit͡ʃek
çiçeklerin	t͡ʃit͡ʃekleɾin
çiçeği	t͡ʃit͡ʃeɰi
çiçeğine	t͡ʃit͡ʃeɰine
çiçeğini	t͡ʃit͡ʃeɰini
ciddi	d͡ʒiddi
ciddiyet	d͡ʒiddijet
çift	t͡ʃift
çifte	t͡ʃifte
çiftin	t͡ʃiftin
çiftlemek	t͡ʃiftlemek
cihaz	d͡ʒihaz
çikolataları	t͡ʃikolatalaɾɯ
çilesi	t͡ʃilesi
cinayet	d͡ʒinajet
cinayeti	d͡ʒinajeti
cinsellikte	d͡ʒinsellikte
çirkin	t͡ʃiɾkin
çiseliyordu	t͡ʃiselijoɾdu
civarında	d͡ʒivaɾɯnda
civcivler	d͡ʒivd͡ʒivleɾ
çizdi	t͡ʃizdi
çizgisinde	t͡ʃizɡisinde
çizgiyi	t͡ʃizɡiji
çoban	t͡ʃoban
çocuk	t͡ʃod͡ʒuk
çocuklar	t͡ʃod͡ʒuklaɾ
çocuklara	t͡ʃod͡ʒuklaɾa
çocuklarımız	t͡ʃod͡ʒuklaɾɯmɯz
çocukların	t͡ʃod͡ʒuklaɾɯn
çocuklarına	t͡ʃod͡ʒuklaɾɯna
çocukluk	t͡ʃod͡ʒukluk
çocukluğunda	t͡ʃod͡ʒukluɰunda
çocuğunu	t͡ʃod͡ʒuɰunu
çok	t͡ʃok
çoktan	t͡ʃoktan
çöküyor	t͡ʃœkyjoɾ
çomak	t͡ʃomak
çöpçülük	t͡ʃœpt͡ʃylyk
çöpe	t͡ʃœpe
çorba	t͡ʃoɾba
courtesy	d͡ʒouɾtesj
çözmek	t͡ʃœzmek
çözüyor	t͡ʃœzyjoɾ
coşkuyu	d͡ʒoʃkuju
coğrafya	d͡ʒoɰɾafja
coşturur	d͡ʒoʃtuɾuɾ
çoğu	t͡ʃoɰu
çoğunluğu	t͡ʃoɰunluɰu
cumhuriyet	d͡ʒumhuɾijet
cumhuriyetçiler	d͡ʒumhuɾijett͡ʃileɾ
cumhuriyetimizin	d͡ʒumhuɾijetimizin
cümleleriyle	d͡ʒymleleɾijle
cümleye	d͡ʒymleje
çünkü	t͡ʃynky
çık	t͡ʃɯk
çıkacak	t͡ʃɯkad͡ʒak
çıkan	t͡ʃɯkan
çıkar	t͡ʃɯkaɾ
çıkarak	t͡ʃɯkaɾak
çıkarmadan	t͡ʃɯkaɾmadan
çıkarmış	t͡ʃɯkaɾmɯʃ
çıkarmıştır	t͡ʃɯkaɾmɯʃtɯɾ
çıkartmaya	t͡ʃɯkaɾtmaja
çıkarttılar	t͡ʃɯkaɾttɯlaɾ
çıkarılmalıydı	t͡ʃɯkaɾɯlmalɯjdɯ
çıkarılması	t͡ʃɯkaɾɯlmasɯ
çıkma	t͡ʃɯkma
çıkmak	t͡ʃɯkmak
çıkmamış	t͡ʃɯkmamɯʃ
çıkmamıştı	t͡ʃɯkmamɯʃtɯ
çıkmıyor	t͡ʃɯkmɯjoɾ
çıkmıyordu	t͡ʃɯkmɯjoɾdu
çıkmış	t͡ʃɯkmɯʃ
çıkmıştı	t͡ʃɯkmɯʃtɯ
çıkmıştım	t͡ʃɯkmɯʃtɯm
çıktı	t͡ʃɯktɯ
çıktık	t͡ʃɯktɯk
çıktıkları	t͡ʃɯktɯklaɾɯ
çıktılar	t͡ʃɯktɯlaɾ
çıktım	t͡ʃɯktɯm
çıktığında	t͡ʃɯktɯɰɯnda
çıkınca	t͡ʃɯkɯnd͡ʒa
çıkıyor	t͡ʃɯkɯjoɾ
çıkıyordu	t͡ʃɯkɯjoɾdu
çıkış	t͡ʃɯkɯʃ
çıkışı	t͡ʃɯkɯʃɯ
çıkışın	t͡ʃɯkɯʃɯn
çıkışından	t͡ʃɯkɯʃɯndan
çıkışırlar	t͡ʃɯkɯʃɯɾlaɾ
çılgın	t͡ʃɯlɡɯn
çıngırak	t͡ʃɯnɡɯɾak
çırptığında	t͡ʃɯɾptɯɰɯnda
çırpı	t͡ʃɯɾpɯ
çırpıda	t͡ʃɯɾpɯda
çırpın	t͡ʃɯɾpɯn
çırpındığı	t͡ʃɯɾpɯndɯɰɯ
çıtır	t͡ʃɯtɯɾ
çığlığı	t͡ʃɯɰlɯɰɯ
da	da
daha	daha
dahi	dahi
dahildir	dahildiɾ
daire	daiɾe
dakika	dakika
dakikada	dakikada
dalgaları	dalɡalaɾɯ
dalgın	dalɡɯn
dallarının	dallaɾɯnɯn
damar	damaɾ
damarı	damaɾɯ
damla	damla
dans	dans
dansa	dansa
danışman	danɯʃman
danışmanı	danɯʃmanɯ
darbe	daɾbe
darbeyle	daɾbejle
darboğazına	daɾboɰazɯna
davası	davasɯ
davet	davet
davetiyemi	davetijemi
davetleri	davetleɾi
davrandılar	davɾandɯlaɾ
davranır	davɾanɯɾ
davranırdı	davɾanɯɾdɯ
davranış	davɾanɯʃ
davranışlar	davɾanɯʃlaɾ
dayamaya	dajamaja
dayanamadı	dajanamadɯ
dayanan	dajanan
dayanarak	dajanaɾak
dağcılık	daɰd͡ʒɯlɯk
dağlarda	daɰlaɾda
dağıldığını	daɰɯldɯɰɯnɯ
dağın	daɰɯn
dağıtmayın	daɰɯtmajɯn
dağıtım	daɰɯtɯm
dağıtır	daɰɯtɯɾ
de	de
dedeciğim	deded͡ʒiɰim
dedektifleri	dedektifleɾi
dedi	dedi
dediklerini	dedikleɾini
dediler	dedileɾ
dedim	dedim
dediği	dediɰi
defa	defa
defada	defada
defans	defans
defile	defile
defnedileceği	defnediled͡ʒeɰi
defterimden	defteɾimden
defterin	defteɾin
deklarasyonun	deklaɾasjonun
deli	deli
delikanlının	delikanlɯnɯn
delirtsem	deliɾtsem
demek	demek
demektir	demektiɾ
demet	demet
demez	demez
demir	demiɾ
demiri	demiɾi
demiş	demiʃ
demişti	demiʃti
demliklerimizin	demlikleɾimizin
demografik	demoɡɾafik
demokratik	demokɾatik
denecek	dened͡ʒek
denemez	denemez
deneyimlerini	denejimleɾini
deneyimli	denejimli
deneyinden	denejinden
denge	denɡe
dengeleri	denɡeleɾi
dengesi	denɡesi
denilen	denilen
deniz	deniz
denizci	denizd͡ʒi
denize	denize
denizler	denizleɾ
depremde	depɾemde
depremleri	depɾemleɾi
depremzedeler	depɾemzedeleɾ
der	deɾ
derde	deɾde
derdi	deɾdi
derdim	deɾdim
derebeyleriyle	deɾebejleɾijle
derece	deɾed͡ʒe
derecede	deɾed͡ʒede
dereden	deɾeden
dergimizin	deɾɡimizin
derginin	deɾɡinin
derin	deɾin
derinlemesine	deɾinlemesine
derken	deɾken
derler	deɾleɾ
ders	deɾs
dersem	deɾsem
dersinin	deɾsinin
dersiniz	deɾsiniz
dersler	deɾsleɾ
derslerinde	deɾsleɾinde
dert	deɾt
dertleşiyordu	deɾtleʃijoɾdu
dertleşmek	deɾtleʃmek
deseler	deseleɾ
despot	despot
destan	destan
destandır	destandɯɾ
destek	destek
detektiflik	detektiflik
devalüasyon	devalyasjon
devalüasyonun	devalyasjonun
devam	devam
devamı	devamɯ
devlet	devlet
devletin	devletin
devletleri	devletleɾi
devraldığı	devɾaldɯɰɯ
devraldığıdır	devɾaldɯɰɯdɯɾ
devralmaya	devɾalmaja
devre	devɾe
devreye	devɾeje
devrildi	devɾildi
devrim	devɾim
devriminden	devɾiminden
deyince	dejind͡ʒe
deyip	dejip
deyiverir	dejiveɾiɾ
deyiş	dejiʃ
deyişteki	dejiʃteki
değer	deɰeɾ
değerini	deɰeɾini
değerlendireceğinizi	deɰeɾlendiɾed͡ʒeɰinizi
değerlendiren	deɰeɾlendiɾen
değerlendiriyorsunuz	deɰeɾlendiɾijoɾsunuz
değerlendirme	deɰeɾlendiɾme
değerlendirmek	deɰeɾlendiɾmek
değerlendirmekti	deɰeɾlendiɾmekti
değerlerini	deɰeɾleɾini
değil	deɰil
değildi	deɰildi
değildir	deɰildiɾ
değilim	deɰilim
değiliz	deɰiliz
değindi	deɰindi
değişerek	deɰiʃeɾek
değişik	deɰiʃik
değişim	deɰiʃim
değişiyor	deɰiʃijoɾ
değişiyorsa	deɰiʃijoɾsa
değişmesi	deɰiʃmesi
değiştiren	deɰiʃtiɾen
değiştirme	deɰiʃtiɾme
değiştirmedik	deɰiʃtiɾmedik
di	di
dibe	dibe
dibine	dibine
didikler	didikleɾ
dik	dik
dikensiz	dikensiz
dikerdim	dikeɾdim
dikildi	dikildi
dikilince	dikilind͡ʒe
dikip	dikip
dikiyorlar	dikijoɾlaɾ
dikiyorlardı	dikijoɾlaɾdɯ
dikkat	dikkat
dikkate	dikkate
dikkati	dikkati
dikkatini	dikkatini
dikkatli	dikkatli
dikkatlice	dikkatlid͡ʒe
dikleniveriyor	dikleniveɾijoɾ
diktatörce	diktatœɾd͡ʒe
dile	dile
dileklerini	dilekleɾini
dilekte	dilekte
dilenci	dilend͡ʒi
diler	dileɾ
dilim	dilim
dilimiz	dilimiz
dilimler	dilimleɾ
dilimleyin	dilimlejin
dilini	dilini
dilinin	dilinin
dille	dille
dillendirme	dillendiɾme
dim	dim
din	din
dinamikler	dinamikleɾ
dinlemek	dinlemek
dinlemeye	dinlemeje
dinleneceğimiz	dinlened͡ʒeɰimiz
dinlenilen	dinlenilen
dinlere	dinleɾe
dinlerine	dinleɾine
dinleyiciler	dinlejid͡ʒileɾ
dinleyin	dinlejin
diplomasi	diplomasi
diploması	diplomasɯ
diplomatlarının	diplomatlaɾɯnɯn
dir	diɾ
direktörü	diɾektœɾy
dirler	diɾleɾ
dirsekten	diɾsekten
disiplinliydi	disiplinlijdi
diyalize	dijalize
diye	dije
diyecek	dijed͡ʒek
diyecekler	dijed͡ʒekleɾ
diyelim	dijelim
diyen	dijen
diyerek	dijeɾek
diyet	dijet
diyor	dijoɾ
diyordu	dijoɾdu
diyordum	dijoɾdum
diyormuş	dijoɾmuʃ
diyorum	dijoɾum
dizilmiş	dizilmiʃ
diğer	diɰeɾ
dişi	diʃi
dk	dk
dökebiliyordu	dœkebilijoɾdu
doktorlar	doktoɾlaɾ
doktoru	doktoɾu
doktorudurlar	doktoɾuduɾlaɾ
dokundurulmadan	dokunduɾulmadan
döküntü	dœkynty
dokusu	dokusu
döküyorlar	dœkyjoɾlaɾ
dolan	dolan
dolar	dolaɾ
doların	dolaɾɯn
dolayı	dolajɯ
dolayında	dolajɯnda
dolayısıyla	dolajɯsɯjla
dolaşacak	dolaʃad͡ʒak
doldurdu	dolduɾdu
doldurduğu	dolduɾduɰu
doldurulacaktır	dolduɾulad͡ʒaktɯɾ
doldurun	dolduɾun
dolduruyor	dolduɾujoɾ
dolmalık	dolmalɯk
dolu	dolu
domates	domates
döndü	dœndy
döndüğünde	dœndyɰynde
dönebiliyor	dœnebilijoɾ
dönecek	dœned͡ʒek
döneceksin	dœned͡ʒeksin
döneceksindir	dœned͡ʒeksindiɾ
döneceği	dœned͡ʒeɰi
dönemde	dœnemde
dönemden	dœnemden
dönemin	dœnemin
döneminde	dœneminde
dönemine	dœnemine
dönemlerdeki	dœnemleɾdeki
dönemlerinde	dœnemleɾinde
dönen	dœnen
döner	dœneɾ
dönerler	dœneɾleɾ
dönerlerki	dœneɾleɾki
dönmesini	dœnmesini
dönmüş	dœnmyʃ
dönülür	dœnylyɾ
dönümü	dœnymy
dönüşen	dœnyʃen
dönüşlerinde	dœnyʃleɾinde
dönüşmesi	dœnyʃmesi
dönüşü	dœnyʃy
dört	dœɾt
dörtlü	dœɾtly
dost	dost
dostları	dostlaɾɯ
dostlarınız	dostlaɾɯnɯz
dosyalarını	dosjalaɾɯnɯ
dövdüler	dœvdyleɾ
döviz	dœviz
dövizde	dœvizde
dövizdeki	dœvizdeki
dövizi	dœvizi
doygun	dojɡun
doyurana	dojuɾana
doyurayım	dojuɾajɯm
doğal	doɰal
doğalgazda	doɰalɡazda
doğalgazın	doɰalɡazɯn
doğan	doɰan
doğanları	doɰanlaɾɯ
doğranmış	doɰɾanmɯʃ
doğru	doɰɾu
doğrudan	doɰɾudan
doğrulamaya	doɰɾulamaja
doğrusunu	doɰɾusunu
doğum	doɰum
doğumların	doɰumlaɾɯn
doğuş	doɰuʃ
doğuşu	doɰuʃu
du	du
dü	dy
duayenlerin	duajenleɾin
düeti	dyeti
dükkan	dykkan
dükkanın	dykkanɯn
dükkanınızı	dykkanɯnɯzɯ
dum	dum
dün	dyn
dünya	dynja
dünyada	dynjada
dünyanın	dynjanɯn
dünyası	dynjasɯ
dünyasında	dynjasɯnda
dünyasıyla	dynjasɯjla
dünyayı	dynjajɯ
dünyevi	dynjevi
dur	duɾ
dür	dyɾ
durakta	duɾakta
durdu	duɾdu
durdurulabildi	duɾduɾulabildi
durdurulması	duɾduɾulmasɯ
durdurup	duɾduɾup
durduttuğu	duɾduttuɰu
durduğu	duɾduɰu
durlar	duɾlaɾ
durmaz	duɾmaz
dürtüyor	dyɾtyjoɾ
durulması	duɾulmasɯ
durum	duɾum
duruma	duɾuma
durumdan	duɾumdan
durumlarda	duɾumlaɾda
durumları	duɾumlaɾɯ
durumu	duɾumu
durumuma	duɾumuma
durumunda	duɾumunda
durur	duɾuɾ
dürüst	dyɾyst
duruyor	duɾujoɾ
duyamaz	dujamaz
duyar	dujaɾ
duyarlı	dujaɾlɯ
duyarlılığını	dujaɾlɯlɯɰɯnɯ
duyarız	dujaɾɯz
duydu	dujdu
duyduk	dujduk
duyduğunu	dujduɰunu
duygu	dujɡu
duygudan	dujɡudan
duyguları	dujɡulaɾɯ
duygularını	dujɡulaɾɯnɯ
duygusal	dujɡusal
duygusallıkta	dujɡusallɯkta
duymadan	dujmadan
duymuyor	dujmujoɾ
duyulamaz	dujulamaz
duyulan	dujulan
duyulsun	dujulsun
duyurdu	dujuɾdu
düz	dyz
düzelse	dyzelse
düzende	dyzende
düzene	dyzene
düzeni	dyzeni
düzenledikleri	dyzenledikleɾi
düzenlemesi	dyzenlemesi
düzenlenen	dyzenlenen
düzenlenir	dyzenleniɾ
düzenleyecek	dyzenlejed͡ʒek
düzenleyen	dyzenlejen
düzenli	dyzenli
düzenliyor	dyzenlijoɾ
düzenliyordu	dyzenlijoɾdu
düzeyde	dyzejde
düzeyinde	dyzejinde
düzlükte	dyzlykte
düş	dyʃ
düşecek	dyʃed͡ʒek
düşecektir	dyʃed͡ʒektiɾ
düşer	dyʃeɾ
düşerdi	dyʃeɾdi
düşerken	dyʃeɾken
düşkün	dyʃkyn
düşkündür	dyʃkyndyɾ
düşkündürler	dyʃkyndyɾleɾ
düşkünlüğünü	dyʃkynlyɰyny
düşler	dyʃleɾ
düşmanca	dyʃmand͡ʒa
düşmanla	dyʃmanla
düşmanların	dyʃmanlaɾɯn
düşmanı	dyʃmanɯ
düğmenin	dyɰmenin
düğmeye	dyɰmeje
duşta	duʃta
düşük	dyʃyk
düğün	dyɰyn
düşünce	dyʃynd͡ʒe
düşüncelerini	dyʃynd͡ʒeleɾini
düşüncenin	dyʃynd͡ʒenin
düşüncesine	dyʃynd͡ʒesine
düşündüren	dyʃyndyɾen
düşündüğüm	dyʃyndyɰym
düşündüğümü	dyʃyndyɰymy
düşündüğünü	dyʃyndyɰyny
düşünememiş	dyʃynememiʃ
düşünememişti	dyʃynememiʃti
düşünen	dyʃynen
düşünmeden	dyʃynmeden
düşünmedi	dyʃynmedi
düşünmek	dyʃynmek
düşünmemişiz	dyʃynmemiʃiz
düşünmez	dyʃynmez
düşünmüş	dyʃynmyʃ
düşünülerek	dyʃynyleɾek
düşünüp	dyʃynyp
düşünür	dyʃynyɾ
düşünürken	dyʃynyɾken
düşüp	dyʃyp
düşürücü	dyʃyɾyd͡ʒy
düşürülmesine	dyʃyɾylmesine
düşüyor	dyʃyjoɾ
dı	dɯ
dık	dɯk
dır	dɯɾ
dış	dɯʃ
dışarı	dɯʃaɾɯ
dışarıya	dɯʃaɾɯja
dışında	dɯʃɯnda
e	e
edasına	edasɯna
edayla	edajla
edebilecek	edebiled͡ʒek
edebilir	edebiliɾ
edebilirim	edebiliɾim
edebilmesi	edebilmesi
edecek	eded͡ʒek
edeceğini	eded͡ʒeɰini
edelim	edelim
edemem	edemem
edememiş	edememiʃ
edemiyor	edemijoɾ
edemiyorum	edemijoɾum
eden	eden
eder	edeɾ
ederek	edeɾek
ederim	edeɾim
ederken	edeɾken
edildi	edildi
edildiği	edildiɰi
edildiğinde	edildiɰinde
edildiğinden	edildiɰinden
edilecek	ediled͡ʒek
edileceğini	ediled͡ʒeɰini
edilegelmiştir	edileɡelmiʃtiɾ
edilen	edilen
edilir	ediliɾ
edilmene	edilmene
edilmesi	edilmesi
edin	edin
edindikleri	edindikleɾi
edinmiş	edinmiʃ
edinmiştir	edinmiʃtiɾ
edip	edip
ediyor	edijoɾ
ediyordu	edijoɾdu
ediyorduk	edijoɾduk
ediyorlar	edijoɾlaɾ
ediyorsa	edijoɾsa
ediyorsam	edijoɾsam
ediyorsun	edijoɾsun
efsanelerine	efsaneleɾine
efsanesine	efsanesine
egemen	eɡemen
egemenliği	eɡemenliɰi
egoizm	eɡoizm
ekibi	ekibi
ekilecek	ekiled͡ʒek
ekimde	ekimde
ekip	ekip
ekipken	ekipken
eklenebilir	eklenebiliɾ
ekleniyor	eklenijoɾ
ekleyebilirsiniz	eklejebiliɾsiniz
ekleyerek	eklejeɾek
ekmek	ekmek
ekmeği	ekmeɰi
ekonomiden	ekonomiden
ekonomik	ekonomik
ekonominin	ekonominin
ekonomisi	ekonomisi
eksikli	eksikli
eksiksiz	eksiksiz
el	el
elbet	elbet
elde	elde
ele	ele
elenirken	eleniɾken
eleştiren	eleʃtiɾen
eleştiri	eleʃtiɾi
eleştirilen	eleʃtiɾilen
elin	elin
elinde	elinde
ellerden	elleɾden
ellerini	elleɾini
elzem	elzem
emekli	emekli
emeklilik	emeklilik
emekliye	emeklije
emindim	emindim
emirleri	emiɾleɾi
emisyon	emisjon
emisyonları	emisjonlaɾɯ
empatik	empatik
emperyalizminin	empeɾjalizminin
emri	emɾi
emriniz	emɾiniz
emzirmeli	emziɾmeli
en	en
enerji	eneɾʒi
enerjinin	eneɾʒinin
enerjisi	eneɾʒisi
enerjisini	eneɾʒisini
enflasyon	enflasjon
enflasyonu	enflasjonu
enflasyonun	enflasjonun
engellemek	enɡellemek
engellemektedir	enɡellemektediɾ
engelliyorum	enɡellijoɾum
enlemesine	enlemesine
ensesinde	ensesinde
entellektüel	entellektyel
epizodda	epizodda
er	eɾ
erdemler	eɾdemleɾ
ergenlik	eɾɡenlik
erişince	eɾiʃind͡ʒe
erkek	eɾkek
erkekler	eɾkekleɾ
erkekleri	eɾkekleɾi
erken	eɾken
erkeği	eɾkeɰi
erkeğiydi	eɾkeɰijdi
esas	esas
eser	eseɾ
esiyor	esijoɾ
esiyorsa	esijoɾsa
eski	eski
eskisi	eskisi
esmerlikleri	esmeɾlikleɾi
esnafı	esnafɯ
estetik	estetik
et	et
etkenler	etkenleɾ
etki	etki
etkilediği	etkilediɰi
etkilemiş	etkilemiʃ
etkilemiştir	etkilemiʃtiɾ
etkileri	etkileɾi
etkilerinin	etkileɾinin
etkileyici	etkilejid͡ʒi
etkiliyor	etkilijoɾ
etkinliklerle	etkinlikleɾle
etkisi	etkisi
etkisiyle	etkisijle
etleri	etleɾi
etme	etme
etmeden	etmeden
etmediler	etmedileɾ
etmedim	etmedim
etmek	etmek
etmektedir	etmektediɾ
etmektir	etmektiɾ
etmesi	etmesi
etmeye	etmeje
etmeyeceğim	etmejed͡ʒeɰim
etmeyeceğini	etmejed͡ʒeɰini
etmeyi	etmeji
etmezdin	etmezdin
etmiş	etmiʃ
etmişti	etmiʃti
etmiştir	etmiʃtiɾ
etnik	etnik
etsek	etsek
etseydin	etsejdin
etsin	etsin
etti	etti
ettik	ettik
ettim	ettim
ettiğim	ettiɰim
ettiğin	ettiɰin
ev	ev
evden	evden
eve	eve
evhamlar	evhamlaɾ
evi	evi
evimden	evimden
evine	evine
evladım	evladɯm
evlendirmek	evlendiɾmek
evlenemeyecek	evlenemejed͡ʒek
evli	evli
evlilik	evlilik
evliliklerinden	evlilikleɾinden
evrenin	evɾenin
evvel	evvel
eyleme	ejleme
eylemi	ejlemi
eylül	ejlyl
ezmiş	ezmiʃ
eğer	eɰeɾ
eğilimleri	eɰilimleɾi
eşini	eʃini
eğitim	eɰitim
eğitimli	eɰitimli
eğlence	eɰlend͡ʒe
eğlenceler	eɰlend͡ʒeleɾ
eşliğinde	eʃliɰinde
eşyalar	eʃjalaɾ
faaliyete	faalijete
faaliyetleri	faalijetleɾi
faaliyette	faalijette
fabrikaları	fabɾikalaɾɯ
faizlerin	faizleɾin
fakat	fakat
faktörünün	faktœɾynyn
fakülteler	fakylteleɾ
falan	falan
fanteziyi	fanteziji
fark	faɾk
farketmişler	faɾketmiʃleɾ
farklı	faɾklɯ
farklılığını	faɾklɯlɯɰɯnɯ
farksızdır	faɾksɯzdɯɾ
farkı	faɾkɯ
farkımız	faɾkɯmɯz
farkın	faɾkɯn
farkında	faɾkɯnda
faydalanıp	fajdalanɯp
faydası	fajdasɯ
fazla	fazla
fazlalığı	fazlalɯɰɯ
faşistlerin	faʃistleɾin
federasyon	fedeɾasjon
felaketten	felaketten
felsefesi	felsefesi
feminist	feminist
feodal	feodal
fesleğen	fesleɰen
fidanlar	fidanlaɾ
figürü	fiɡyɾy
fikri	fikɾi
filan	filan
filminde	filminde
finansmanı	finansmanɯ
fincanı	find͡ʒanɯ
firmalar	fiɾmalaɾ
fiyat	fijat
fiyatlarla	fijatlaɾla
fiyatları	fijatlaɾɯ
fiyatlarının	fijatlaɾɯnɯn
fiyatı	fijatɯ
fiyatına	fijatɯna
fizik	fizik
fiziksel	fiziksel
fiziğin	fiziɰin
forsum	foɾsum
forvet	foɾvet
futbol	futbol
futbolcuların	futbold͡ʒulaɾɯn
fındık	fɯndɯk
fırçaları	fɯɾt͡ʃalaɾɯ
fırlamış	fɯɾlamɯʃ
fırlamıştı	fɯɾlamɯʃtɯ
fırlatıyor	fɯɾlatɯjoɾ
galakside	ɡalakside
galaksideki	ɡalaksideki
galiba	ɡaliba
garip	ɡaɾip
gasp	ɡasp
gay	ɡaj
gayet	ɡajet
gayri	ɡajɾi
gazeteci	ɡazeted͡ʒi
gazeteni	ɡazeteni
gazetesinde	ɡazetesinde
geç	ɡet͡ʃ
gece	ɡed͡ʒe
geçecek	ɡet͡ʃed͡ʒek
geçeceğini	ɡet͡ʃed͡ʒeɰini
gecekondu	ɡed͡ʒekondu
geceleri	ɡed͡ʒeleɾi
geçen	ɡet͡ʃen
geçip	ɡet͡ʃip
geçirdi	ɡet͡ʃiɾdi
geçirdim	ɡet͡ʃiɾdim
geçirilmesi	ɡet͡ʃiɾilmesi
geçiriyordum	ɡet͡ʃiɾijoɾdum
geçirmek	ɡet͡ʃiɾmek
geçirmiş	ɡet͡ʃiɾmiʃ
geçit	ɡet͡ʃit
geçiyormuşçasına	ɡet͡ʃijoɾmuʃt͡ʃasɯna
geçiş	ɡet͡ʃiʃ
geçmek	ɡet͡ʃmek
geçmekten	ɡet͡ʃmekten
geçmemiş	ɡet͡ʃmemiʃ
geçmeye	ɡet͡ʃmeje
geçmez	ɡet͡ʃmez
geçmiyor	ɡet͡ʃmijoɾ
geçmiyordu	ɡet͡ʃmijoɾdu
geçmiş	ɡet͡ʃmiʃ
geçmişi	ɡet͡ʃmiʃi
geçmişimiz	ɡet͡ʃmiʃimiz
geçmişler	ɡet͡ʃmiʃleɾ
geçmişlerdir	ɡet͡ʃmiʃleɾdiɾ
geçmişlerin	ɡet͡ʃmiʃleɾin
geçti	ɡet͡ʃti
geçtiği	ɡet͡ʃtiɰi
geçtiğinde	ɡet͡ʃtiɰinde
geçtiğini	ɡet͡ʃtiɰini
gel	ɡel
geldi	ɡeldi
geldik	ɡeldik
geldiler	ɡeldileɾ
geldim	ɡeldim
geldiği	ɡeldiɰi
geldiğinde	ɡeldiɰinde
gelecek	ɡeled͡ʒek
gelecekte	ɡeled͡ʒekte
gelecektir	ɡeled͡ʒektiɾ
gelemediğinden	ɡelemediɰinden
gelen	ɡelen
gelene	ɡelene
gelenek	ɡelenek
gelenekleriyle	ɡelenekleɾijle
geleneksel	ɡeleneksel
geleni	ɡeleni
gelin	ɡelin
gelip	ɡelip
gelir	ɡeliɾ
gelirim	ɡeliɾim
geliyor	ɡelijoɾ
geliyordu	ɡelijoɾdu
gelişigüzel	ɡeliʃiɡyzel
gelişimi	ɡeliʃimi
gelişinin	ɡeliʃinin
gelişiyle	ɡeliʃijle
gelişme	ɡeliʃme
gelişmesini	ɡeliʃmesini
gelişti	ɡeliʃti
geliştirilmesi	ɡeliʃtiɾilmesi
geliştirilmiş	ɡeliʃtiɾilmiʃ
geliştirir	ɡeliʃtiɾiɾ
gelmedi	ɡelmedi
gelmek	ɡelmek
gelmez	ɡelmez
gelmiş	ɡelmiʃ
gelseydi	ɡelsejdi
gemim	ɡemim
genç	ɡent͡ʃ
gençlerin	ɡent͡ʃleɾin
gene	ɡene
genel	ɡenel
genellikle	ɡenellikle
geniş	ɡeniʃ
gerçek	ɡeɾt͡ʃek
gerçekçileşerek	ɡeɾt͡ʃekt͡ʃileʃeɾek
gerçekleşir	ɡeɾt͡ʃekleʃiɾ
gerçekleştirebilmek	ɡeɾt͡ʃekleʃtiɾebilmek
gerçekleştiren	ɡeɾt͡ʃekleʃtiɾen
gerçekleştiğine	ɡeɾt͡ʃekleʃtiɰine
gerçekten	ɡeɾt͡ʃekten
gerçeği	ɡeɾt͡ʃeɰi
gerek	ɡeɾek
gereken	ɡeɾeken
gerekir	ɡeɾekiɾ
gerekiyor	ɡeɾekijoɾ
gerekiyordu	ɡeɾekijoɾdu
gerekiyormuş	ɡeɾekijoɾmuʃ
gerekli	ɡeɾekli
gerekmektedir	ɡeɾekmektediɾ
gerekmiyor	ɡeɾekmijoɾ
gereksinmeleri	ɡeɾeksinmeleɾi
gerekti	ɡeɾekti
gerektiriyor	ɡeɾektiɾijoɾ
gerektiğine	ɡeɾektiɰine
gerektiğini	ɡeɾektiɰini
gereğini	ɡeɾeɰini
geri	ɡeɾi
gerizekalıyım	ɡeɾizekalɯjɯm
getirdi	ɡetiɾdi
getirdim	ɡetiɾdim
getirdiğiniz	ɡetiɾdiɰiniz
getireceğime	ɡetiɾed͡ʒeɰime
getiren	ɡetiɾen
getirildiğini	ɡetiɾildiɰini
getirilmiş	ɡetiɾilmiʃ
getirilmişti	ɡetiɾilmiʃti
getiriyor	ɡetiɾijoɾ
getirmek	ɡetiɾmek
geyikte	ɡejikte
gezdik	ɡezdik
gezdiriyorlardı	ɡezdiɾijoɾlaɾdɯ
gezer	ɡezeɾ
gezginliğini	ɡezɡinliɰini
geziyormuşum	ɡezijoɾmuʃum
gezmekle	ɡezmekle
gezmiş	ɡezmiʃ
gibi	ɡibi
giden	ɡiden
gider	ɡideɾ
giderler	ɡideɾleɾ
gidip	ɡidip
gidiyor	ɡidijoɾ
gidiyordu	ɡidijoɾdu
gidiyorlardı	ɡidijoɾlaɾdɯ
gidişat	ɡidiʃat
girdi	ɡiɾdi
girdik	ɡiɾdik
girdiklerinde	ɡiɾdikleɾinde
girdiler	ɡiɾdileɾ
girdiği	ɡiɾdiɰi
girdiğimi	ɡiɾdiɰimi
girecekti	ɡiɾed͡ʒekti
giremeyeceğine	ɡiɾemejed͡ʒeɰine
giren	ɡiɾen
girenler	ɡiɾenleɾ
girer	ɡiɾeɾ
girerken	ɡiɾeɾken
girilmeye	ɡiɾilmeje
girip	ɡiɾip
giriyorsunuz	ɡiɾijoɾsunuz
giriş	ɡiɾiʃ
girişin	ɡiɾiʃin
girişte	ɡiɾiʃte
girmeden	ɡiɾmeden
girmek	ɡiɾmek
girmekle	ɡiɾmekle
girmektir	ɡiɾmektiɾ
girmemeye	ɡiɾmemeje
girmesi	ɡiɾmesi
girmesidir	ɡiɾmesidiɾ
girmiş	ɡiɾmiʃ
girmiştim	ɡiɾmiʃtim
git	ɡit
gitmek	ɡitmek
gitmektedir	ɡitmektediɾ
gitmeye	ɡitmeje
gitmiş	ɡitmiʃ
gitmiştik	ɡitmiʃtik
gitti	ɡitti
gittiği	ɡittiɰi
gittiğim	ɡittiɰim
gittiğimde	ɡittiɰimde
gittiğin	ɡittiɰin
giyimciler	ɡijimd͡ʒileɾ
giyinen	ɡijinen
giyme	ɡijme
giymiş	ɡijmiʃ
giysisinin	ɡijsisinin
gizemli	ɡizemli
gizli	ɡizli
göç	ɡœt͡ʃ
gök	ɡœk
gökyüzü	ɡœkjyzy
gol	ɡol
gölgelediği	ɡœlɡelediɰi
gölgesiyle	ɡœlɡesijle
goller	ɡolleɾ
göller	ɡœlleɾ
gömdüğünüz	ɡœmdyɰynyz
gömleklerinize	ɡœmlekleɾinize
gömleğinin	ɡœmleɰinin
gömmüş	ɡœmmyʃ
gömmüştü	ɡœmmyʃty
gömüleceğim	ɡœmyled͡ʒeɰim
gönderdiği	ɡœndeɾdiɰi
gönderen	ɡœndeɾen
gönderilmesine	ɡœndeɾilmesine
gönderimi	ɡœndeɾimi
gönlünü	ɡœnlyny
gönülleri	ɡœnylleɾi
gönüllü	ɡœnylly
gönüllülere	ɡœnyllyleɾe
gördü	ɡœɾdy
gördükçe	ɡœɾdykt͡ʃe
gördüm	ɡœɾdym
gördün	ɡœɾdyn
gördüğüm	ɡœɾdyɰym
gördüğünüz	ɡœɾdyɰynyz
göre	ɡœɾe
görebilir	ɡœɾebiliɾ
göreceği	ɡœɾed͡ʒeɰi
göremedi	ɡœɾemedi
görev	ɡœɾev
göreve	ɡœɾeve
görevimi	ɡœɾevimi
göreviniz	ɡœɾeviniz
görevlerinde	ɡœɾevleɾinde
görevlisi	ɡœɾevlisi
görgü	ɡœɾɡy
görmeden	ɡœɾmeden
görmüş	ɡœɾmyʃ
görüldüğü	ɡœɾyldyɰy
görülebilen	ɡœɾylebilen
görülebilir	ɡœɾylebiliɾ
görülecek	ɡœɾyled͡ʒek
görülecektir	ɡœɾyled͡ʒektiɾ
görülmektedir	ɡœɾylmektediɾ
görülmez	ɡœɾylmez
görünce	ɡœɾynd͡ʒe
göründüğü	ɡœɾyndyɰy
göründüğünü	ɡœɾyndyɰyny
görünmek	ɡœɾynmek
görünmüyor	ɡœɾynmyjoɾ
görüntülerini	ɡœɾyntyleɾini
görüntüsü	ɡœɾyntysy
görüntüsünü	ɡœɾyntysyny
görüntüsüyle	ɡœɾyntysyjle
görünümünde	ɡœɾynymynde
görünümündeki	ɡœɾynymyndeki
görüp	ɡœɾyp
görür	ɡœɾyɾ
görüyor	ɡœɾyjoɾ
görüyordu	ɡœɾyjoɾdu
görüyordum	ɡœɾyjoɾdum
görüş	ɡœɾyʃ
görüşme	ɡœɾyʃme
görüşmemin	ɡœɾyʃmemin
görüştü	ɡœɾyʃty
görüşülmeyeceğine	ɡœɾyʃylmejed͡ʒeɰine
görüşülüp	ɡœɾyʃylyp
gospel	ɡospel
gösterdi	ɡœsteɾdi
gösterdiği	ɡœsteɾdiɰi
gösterecek	ɡœsteɾed͡ʒek
göstererek	ɡœsteɾeɾek
göstergelere	ɡœsteɾɡeleɾe
gösteride	ɡœsteɾide
gösterilmesi	ɡœsteɾilmesi
gösterir	ɡœsteɾiɾ
gösterirler	ɡœsteɾiɾleɾ
gösterirlermiş	ɡœsteɾiɾleɾmiʃ
gösterisinde	ɡœsteɾisinde
gösterisine	ɡœsteɾisine
gösteriyor	ɡœsteɾijoɾ
göstermekse	ɡœsteɾmekse
göstermeyin	ɡœsteɾmejin
götürdüler	ɡœtyɾdyleɾ
götürdüğünde	ɡœtyɾdyɰynde
götürecek	ɡœtyɾed͡ʒek
götürmek	ɡœtyɾmek
götürmüyor	ɡœtyɾmyjoɾ
götürsünler	ɡœtyɾsynleɾ
götürüldü	ɡœtyɾyldy
götürüyordu	ɡœtyɾyjoɾdu
götürüyordur	ɡœtyɾyjoɾduɾ
gövde	ɡœvde
gövdesine	ɡœvdesine
göz	ɡœz
gözaltına	ɡœzaltɯna
gözden	ɡœzden
göze	ɡœze
gözetip	ɡœzetip
gözlem	ɡœzlem
gözlendi	ɡœzlendi
gözlenmez	ɡœzlenmez
gözlenmezken	ɡœzlenmezken
gözlerini	ɡœzleɾini
gözlü	ɡœzly
gözüne	ɡœzyne
gözyaşı	ɡœzjaʃɯ
göğsünü	ɡœɰsyny
göğüsler	ɡœɰysleɾ
gr	ɡɾ
grubuna	ɡɾubuna
gruplandırılır	ɡɾuplandɯɾɯlɯɾ
grupları	ɡɾuplaɾɯ
gruptan	ɡɾuptan
güç	ɡyt͡ʃ
güçbela	ɡyt͡ʃbela
güce	ɡyd͡ʒe
güçlendirirken	ɡyt͡ʃlendiɾiɾken
gücü	ɡyd͡ʒy
gücüyle	ɡyd͡ʒyjle
gül	ɡyl
güldü	ɡyldy
güldüren	ɡyldyɾen
güler	ɡyleɾ
gülümsediğini	ɡylymsediɰini
gülüyorum	ɡylyjoɾum
gün	ɡyn
gündeme	ɡyndeme
günden	ɡynden
gündüzleri	ɡyndyzleɾi
güne	ɡyne
güneydoğusundaki	ɡynejdoɰusundaki
güneş	ɡyneʃ
günkü	ɡynky
günlere	ɡynleɾe
günleri	ɡynleɾi
günlerle	ɡynleɾle
günlük	ɡynlyk
günü	ɡyny
günün	ɡynyn
günışığına	ɡynɯʃɯɰɯna
gürültüyü	ɡyɾyltyjy
güven	ɡyven
güvencesi	ɡyvend͡ʒesi
güvenlik	ɡyvenlik
güvenlikçi	ɡyvenlikt͡ʃi
güvenliği	ɡyvenliɰi
güvenliğine	ɡyvenliɰine
güvenmediğini	ɡyvenmediɰini
güvenmemiz	ɡyvenmemiz
güzel	ɡyzel
güzeldir	ɡyzeldiɾ
güzelliği	ɡyzelliɰi
haber	habeɾ
haberdar	habeɾdaɾ
haberi	habeɾi
haberim	habeɾim
haberler	habeɾleɾ
haberleşiyorlar	habeɾleʃijoɾlaɾ
hacca	had͡ʒd͡ʒa
haccada	had͡ʒd͡ʒada
hafif	hafif
hafifliği	hafifliɰi
hafta	hafta
haftada	haftada
hakkı	hakkɯ
hakkımızı	hakkɯmɯzɯ
hakkında	hakkɯnda
hakkını	hakkɯnɯ
haklı	haklɯ
hal	hal
hâlâ	hâlâ
halat	halat
halatları	halatlaɾɯ
halde	halde
hâlde	hâlde
hale	hale
hali	hali
halidir	halidiɾ
halinde	halinde
haline	haline
haliydi	halijdi
halk	halk
halka	halka
halkın	halkɯn
halleri	halleɾi
hamleler	hamleleɾ
hane	hane
hangi	hanɡi
hanım	hanɯm
hapsettiğiniz	hapsettiɰiniz
harcadığı	haɾd͡ʒadɯɰɯ
harcamalar	haɾd͡ʒamalaɾ
harcamalarında	haɾd͡ʒamalaɾɯnda
harcı	haɾd͡ʒɯ
hareket	haɾeket
harekete	haɾekete
hareketler	haɾeketleɾ
hareketlerini	haɾeketleɾini
hareketlilik	haɾeketlilik
hareketsiz	haɾeketsiz
haritamızda	haɾitamɯzda
haritası	haɾitasɯ
haritasına	haɾitasɯna
has	has
hasretini	hasɾetini
hassasiyetini	hassasijetini
hasta	hasta
hastalanan	hastalanan
hastalar	hastalaɾ
hastaları	hastalaɾɯ
hastaların	hastalaɾɯn
hastalarının	hastalaɾɯnɯn
hastalık	hastalɯk
hastalıklar	hastalɯklaɾ
hastalıklara	hastalɯklaɾa
hastalıklardan	hastalɯklaɾdan
hastalığına	hastalɯɰɯna
hastaneden	hastaneden
hastanın	hastanɯn
hastası	hastasɯ
hasıl	hasɯl
hat	hat
hatalar	hatalaɾ
hatalı	hatalɯ
hatları	hatlaɾɯ
hatta	hatta
hattâ	hattâ
hattı	hattɯ
hatırlanır	hatɯɾlanɯɾ
hava	hava
havadan	havadan
havai	havai
havaidirler	havaidiɾleɾ
havalandırılmalıdır	havalandɯɾɯlmalɯdɯɾ
havanın	havanɯn
havaya	havaja
havuç	havut͡ʃ
havuçları	havut͡ʃlaɾɯ
havuza	havuza
havuzun	havuzun
hayal	hajal
hayallere	hajalleɾe
hayat	hajat
hayata	hajata
hayatla	hajatla
hayatlarınızın	hajatlaɾɯnɯzɯn
hayattan	hajattan
hayatı	hajatɯ
hayatım	hajatɯm
hayatımda	hajatɯmda
hayatımı	hajatɯmɯ
hayatın	hajatɯn
hayli	hajli
hayvan	hajvan
hayır	hajɯɾ
hazineyi	hazineji
hazır	hazɯɾ
hazırladığınız	hazɯɾladɯɰɯnɯz
hazırlanmış	hazɯɾlanmɯʃ
hazırlanmıştı	hazɯɾlanmɯʃtɯ
hazırlık	hazɯɾlɯk
hedef	hedef
hedefi	hedefi
hedefini	hedefini
hedefiyle	hedefijle
hedefleri	hedefleɾi
hedeflerim	hedefleɾim
hediye	hedije
hediyeler	hedijeleɾ
hediyesi	hedijesi
hele	hele
hem	hem
hemen	hemen
henüz	henyz
hep	hep
hepimiz	hepimiz
hepiniz	hepiniz
hepsi	hepsi
hepsini	hepsini
her	heɾ
herhangi	heɾhanɡi
herifçioğlu	heɾift͡ʃioɰlu
herkes	heɾkes
herkese	heɾkese
herkesin	heɾkesin
herkesten	heɾkesten
hesaplamak	hesaplamak
hesaplanan	hesaplanan
hesaplarını	hesaplaɾɯnɯ
hesaplaşmalarla	hesaplaʃmalaɾla
heyecanla	hejed͡ʒanla
heyecanlı	hejed͡ʒanlɯ
heyecanlıydık	hejed͡ʒanlɯjdɯk
heyecanı	hejed͡ʒanɯ
heykeli	hejkeli
hiç	hit͡ʃ
hiçbir	hit͡ʃbiɾ
hiçbiri	hit͡ʃbiɾi
hikâye	hikâje
hikâyesi	hikâjesi
hindiler	hindileɾ
hindistancevizi	hindistand͡ʒevizi
hissedilen	hissedilen
hissetmeye	hissetmeje
hizmet	hizmet
hizmetine	hizmetine
hoca	hod͡ʒa
hocası	hod͡ʒasɯ
hostesi	hostesi
hoş	hoʃ
hücrelerimize	hyd͡ʒɾeleɾimize
hukuk	hukuk
hükümetin	hykymetin
hünerlerini	hyneɾleɾini
huyu	huju
hüznünü	hyznyny
hüzünlerle	hyzynleɾle
huzur	huzuɾ
huzursuzluk	huzuɾsuzluk
huzurunu	huzuɾunu
hırs	hɯɾs
hırsız	hɯɾsɯz
hız	hɯz
hızla	hɯzla
hızlanmış	hɯzlanmɯʃ
hızlanmıştır	hɯzlanmɯʃtɯɾ
hızlı	hɯzlɯ
ibresinin	ibɾesinin
iç	it͡ʃ
içeceklerden	it͡ʃed͡ʒekleɾden
içeri	it͡ʃeɾi
içerisinde	it͡ʃeɾisinde
içeriye	it͡ʃeɾije
içi	it͡ʃi
içimiz	it͡ʃimiz
içimizden	it͡ʃimizden
için	it͡ʃin
içinde	it͡ʃinde
içindeki	it͡ʃindeki
içindeydiler	it͡ʃindejdileɾ
içine	it͡ʃine
içini	it͡ʃini
içinize	it͡ʃinize
içmek	it͡ʃmek
içsel	it͡ʃsel
idare	idaɾe
iddia	iddia
iddialardan	iddialaɾdan
ideal	ideal
idi	idi
idik	idik
idmanda	idmanda
ifade	ifade
ifadeler	ifadeleɾ
ifadelere	ifadeleɾe
ifadelerini	ifadeleɾini
ifadesini	ifadesini
ihalesi	ihalesi
ihbar	ihbaɾ
ihracat	ihɾad͡ʒat
ihtimalle	ihtimalle
ihtiyaç	ihtijat͡ʃ
ihtiyacı	ihtijad͡ʒɯ
ihtiyacım	ihtijad͡ʒɯm
ihtiyacınız	ihtijad͡ʒɯnɯz
iken	iken
iki	iki
ikinci	ikind͡ʒi
ikindi	ikindi
ikisinin	ikisinin
ikişerden	ikiʃeɾden
ikram	ikɾam
iktidara	iktidaɾa
iktidarını	iktidaɾɯnɯ
ilaç	ilat͡ʃ
ilan	ilan
ile	ile
ilerde	ileɾde
ilerici	ileɾid͡ʒi
ileride	ileɾide
ilerledi	ileɾledi
ilerleme	ileɾleme
ilerlemelerle	ileɾlemeleɾle
iletebilecek	iletebiled͡ʒek
iletim	iletim
iletişim	iletiʃim
iletişimi	iletiʃimi
ilettim	ilettim
ilgi	ilɡi
ilgilendiren	ilɡilendiɾen
ilgili	ilɡili
ilginç	ilɡint͡ʃ
ilgisi	ilɡisi
ilgisini	ilɡisini
ilgiyi	ilɡiji
ilhamlar	ilhamlaɾ
ilim	ilim
ilişkilerin	iliʃkileɾin
ilişkilerinde	iliʃkileɾinde
ilişkilerine	iliʃkileɾine
ilişkilerle	iliʃkileɾle
ilişkimiz	iliʃkimiz
ilişkin	iliʃkin
ilişkisine	iliʃkisine
ilk	ilk
ilkel	ilkel
illa	illa
ille	ille
illeriyle	illeɾijle
iltifat	iltifat
iltihaplarını	iltihaplaɾɯnɯ
imgenin	imɡenin
imgesiyle	imɡesijle
imkan	imkan
imtihan	imtihan
imza	imza
imzaladı	imzaladɯ
imzalarla	imzalaɾla
inanç	inant͡ʃ
inancı	inand͡ʒɯ
inanmak	inanmak
inanmış	inanmɯʃ
inanmıştı	inanmɯʃtɯ
inanılmaz	inanɯlmaz
inanıyorum	inanɯjoɾum
inatla	inatla
ince	ind͡ʒe
incelemiş	ind͡ʒelemiʃ
incelenirler	ind͡ʒeleniɾleɾ
inceleyeceğimiz	ind͡ʒelejed͡ʒeɰimiz
inceleyici	ind͡ʒelejid͡ʒi
incelik	ind͡ʒelik
indi	indi
indirilirken	indiɾiliɾken
inince	inind͡ʒe
iniş	iniʃ
inmiş	inmiʃ
inmişti	inmiʃti
insan	insan
insana	insana
insandan	insandan
insandır	insandɯɾ
insani	insani
insanlar	insanlaɾ
insanlara	insanlaɾa
insanlardan	insanlaɾdan
insanlarla	insanlaɾla
insanları	insanlaɾɯ
insanların	insanlaɾɯn
insanlığa	insanlɯɰa
insanı	insanɯ
insanın	insanɯn
intihar	intihaɾ
inşa	inʃa
iptal	iptal
iradesi	iɾadesi
irdeleyici	iɾdelejid͡ʒi
irtibatı	iɾtibatɯ
irtifa	iɾtifa
is	is
isabet	isabet
ise	ise
isim	isim
isimlerle	isimleɾle
isimli	isimli
iskele	iskele
iskeleye	iskeleje
ismi	ismi
ismimin	ismimin
istasyon	istasjon
istedi	istedi
istedikleri	istedikleɾi
istediklerinizi	istedikleɾinizi
istedim	istedim
istediği	istediɰi
istediğimde	istediɰimde
istediğini	istediɰini
isteklerle	istekleɾle
istemedi	istemedi
istemediniz	istemediniz
istemektedir	istemektediɾ
istemiş	istemiʃ
istemiştik	istemiʃtik
istendi	istendi
isteniyorsa	istenijoɾsa
ister	isteɾ
isterdim	isteɾdim
isteriz	isteɾiz
isterler	isteɾleɾ
isterse	isteɾse
isterseniz	isteɾseniz
isteyeceksiniz	istejed͡ʒeksiniz
isteyenlere	istejenleɾe
isteyeyim	istejejim
isteği	isteɰi
istiyor	istijoɾ
istiyordu	istijoɾdu
istiyorsanız	istijoɾsanɯz
istiyorsunuz	istijoɾsunuz
istiyorum	istijoɾum
istiyoruz	istijoɾuz
isyan	isjan
isyanından	isjanɯndan
itfaiye	itfaije
ithal	ithal
ithalatı	ithalatɯ
ithalatında	ithalatɯnda
itibaren	itibaɾen
itibarıyla	itibaɾɯjla
itiraz	itiɾaz
itirazları	itiɾazlaɾɯ
itirazını	itiɾazɯnɯ
itiyordu	itijoɾdu
itti	itti
ivmenin	ivmenin
iyi	iji
iyice	ijid͡ʒe
iyileştirmek	ijileʃtiɾmek
izinden	izinden
izleri	izleɾi
izlerken	izleɾken
izliyor	izlijoɾ
izliyordu	izlijoɾdu
izole	izole
iş	iʃ
işadamları	iʃadamlaɾɯ
işçiler	iʃt͡ʃileɾ
işçilikle	iʃt͡ʃilikle
işe	iʃe
işgal	iʃɡal
işi	iʃi
işleme	iʃleme
işlemiş	iʃlemiʃ
işlemiştir	iʃlemiʃtiɾ
işlenmesi	iʃlenmesi
işler	iʃleɾ
işleri	iʃleɾi
işletiliyordu	iʃletilijoɾdu
iğne	iɰne
işsiz	iʃsiz
iştah	iʃtah
işte	iʃte
kaba	kaba
kabahatli	kabahatli
kabalaşabilir	kabalaʃabiliɾ
kabuklarını	kabuklaɾɯnɯ
kabul	kabul
kaç	kat͡ʃ
kaçacaktım	kat͡ʃad͡ʒaktɯm
kaçak	kat͡ʃak
kaçın	kat͡ʃɯn
kadar	kadaɾ
kadardı	kadaɾdɯ
kadarını	kadaɾɯnɯ
kadrolar	kadɾolaɾ
kadın	kadɯn
kadına	kadɯna
kadınlar	kadɯnlaɾ
kadınlardan	kadɯnlaɾdan
kadının	kadɯnɯn
kadınını	kadɯnɯnɯ
kafam	kafam
kafamda	kafamda
kafamdan	kafamdan
kafasında	kafasɯnda
kafayı	kafajɯ
kahkahalar	kahkahalaɾ
kahraman	kahɾaman
kahramanı	kahɾamanɯ
kahve	kahve
kahvenin	kahvenin
kahveye	kahveje
kahveyi	kahveji
kal	kal
kalabalıktan	kalabalɯktan
kalabalığın	kalabalɯɰɯn
kalacak	kalad͡ʒak
kalacaktır	kalad͡ʒaktɯɾ
kalan	kalan
kalanlar	kalanlaɾ
kalanlara	kalanlaɾa
kalbi	kalbi
kaldı	kaldɯ
kaldın	kaldɯn
kaldıramazdım	kaldɯɾamazdɯm
kaldırılacağını	kaldɯɾɯlad͡ʒaɰɯnɯ
kaldırımın	kaldɯɾɯmɯn
kaldığımız	kaldɯɰɯmɯz
kaldığından	kaldɯɰɯndan
kale	kale
kaleme	kaleme
kalkmadan	kalkmadan
kalktı	kalktɯ
kalktım	kalktɯm
kalkınma	kalkɯnma
kalkınmanın	kalkɯnmanɯn
kalkıp	kalkɯp
kalkıyor	kalkɯjoɾ
kalkıyordu	kalkɯjoɾdu
kalkışır	kalkɯʃɯɾ
kalkışırlar	kalkɯʃɯɾlaɾ
kalmadıysa	kalmadɯjsa
kalmamış	kalmamɯʃ
kalmamıştı	kalmamɯʃtɯ
kalması	kalmasɯ
kalmaya	kalmaja
kalmazdın	kalmazdɯn
kalmıyor	kalmɯjoɾ
kalmış	kalmɯʃ
kalmıştı	kalmɯʃtɯ
kalıcı	kalɯd͡ʒɯ
kalınmalıdır	kalɯnmalɯdɯɾ
kalıp	kalɯp
kalıplardan	kalɯplaɾdan
kalırdık	kalɯɾdɯk
kamera	kameɾa
kamp	kamp
kampanyası	kampanjasɯ
kamuoyunu	kamuojunu
kamyona	kamjona
kan	kan
kanalına	kanalɯna
kanamaya	kanamaja
kanat	kanat
kanatlarını	kanatlaɾɯnɯ
kanatlarının	kanatlaɾɯnɯn
kanser	kanseɾ
kap	kap
kapakçık	kapakt͡ʃɯk
kapalı	kapalɯ
kapan	kapan
kapasiteli	kapasiteli
kapasitesi	kapasitesi
kapasitesiyle	kapasitesijle
kapatmalıyım	kapatmalɯjɯm
kapatılmaması	kapatɯlmamasɯ
kapatın	kapatɯn
kapatıncaya	kapatɯnd͡ʒaja
kapsamda	kapsamda
kapsamında	kapsamɯnda
kapta	kapta
kaptaki	kaptaki
kaptırmak	kaptɯɾmak
kapuçino	kaput͡ʃino
kapılardan	kapɯlaɾdan
kapılarını	kapɯlaɾɯnɯ
kapılır	kapɯlɯɾ
kapısına	kapɯsɯna
kapışıyorlar	kapɯʃɯjoɾlaɾ
kapışıyorlardı	kapɯʃɯjoɾlaɾdɯ
kara	kaɾa
karakol	kaɾakol
karakolunda	kaɾakolunda
karalama	kaɾalama
karalıyordum	kaɾalɯjoɾdum
karanlık	kaɾanlɯk
karanlığa	kaɾanlɯɰa
karar	kaɾaɾ
kararlarla	kaɾaɾlaɾla
kararlaştırdık	kaɾaɾlaʃtɯɾdɯk
kararı	kaɾaɾɯ
karaya	kaɾaja
kardeş	kaɾdeʃ
kardeşim	kaɾdeʃim
kardeşinden	kaɾdeʃinden
kardeşlere	kaɾdeʃleɾe
kardeşlerin	kaɾdeʃleɾin
kardeşliğinin	kaɾdeʃliɰinin
kargo	kaɾɡo
kariyerlerinin	kaɾijeɾleɾinin
karneleriyle	kaɾneleɾijle
karnımı	kaɾnɯmɯ
karnını	kaɾnɯnɯ
kart	kaɾt
karta	kaɾta
kartı	kaɾtɯ
kartını	kaɾtɯnɯ
karılarına	kaɾɯlaɾɯna
karıncık	kaɾɯnd͡ʒɯk
karısının	kaɾɯsɯnɯn
karşı	kaɾʃɯ
karşıda	kaɾʃɯda
karşıdaki	kaɾʃɯdaki
karşılama	kaɾʃɯlama
karşılarındakinin	kaɾʃɯlaɾɯndakinin
karşılayıp	kaɾʃɯlajɯp
karşılaşan	kaɾʃɯlaʃan
karşılaştı	kaɾʃɯlaʃtɯ
karşılaşıyoruz	kaɾʃɯlaʃɯjoɾuz
karşılık	kaɾʃɯlɯk
karşılıklı	kaɾʃɯlɯklɯ
karşılığı	kaɾʃɯlɯɰɯ
karşımıza	kaɾʃɯmɯza
karşın	kaɾʃɯn
karşısına	kaɾʃɯsɯna
karşısında	kaɾʃɯsɯnda
karşısındakine	kaɾʃɯsɯndakine
karşısındakinin	kaɾʃɯsɯndakinin
karşısındayım	kaɾʃɯsɯndajɯm
karıştırılır	kaɾɯʃtɯɾɯlɯɾ
karıştırın	kaɾɯʃtɯɾɯn
karıştırıyorum	kaɾɯʃtɯɾɯjoɾum
karşıya	kaɾʃɯja
karışık	kaɾɯʃɯk
kasabada	kasabada
kasede	kasede
kasetlerin	kasetleɾin
kasetlerinin	kasetleɾinin
kasımının	kasɯmɯnɯn
katilleri	katilleɾi
katkı	katkɯ
katkısından	katkɯsɯndan
katlanmak	katlanmak
katma	katma
katı	katɯ
katılmasıyla	katɯlmasɯjla
katılmış	katɯlmɯʃ
katılmıştı	katɯlmɯʃtɯ
kavak	kavak
kavga	kavɡa
kavgası	kavɡasɯ
kavim	kavim
kavramalıyız	kavɾamalɯjɯz
kavurun	kavuɾun
kavuşan	kavuʃan
kavuşması	kavuʃmasɯ
kavuşup	kavuʃup
kaybeden	kajbeden
kaybetmedim	kajbetmedim
kaybettik	kajbettik
kaybından	kajbɯndan
kaydettiler	kajdettileɾ
kaymakam	kajmakam
kaynak	kajnak
kaynaklanamaz	kajnaklanamaz
kaynaklanan	kajnaklanan
kaynaklardan	kajnaklaɾdan
kaynaklarına	kajnaklaɾɯna
kaynama	kajnama
kaynanasının	kajnanasɯnɯn
kaynatın	kajnatɯn
kaynağa	kajnaɰa
kaynağı	kajnaɰɯ
kayıp	kajɯp
kayıt	kajɯt
kaz	kaz
kazan	kazan
kazanacak	kazanad͡ʒak
kazanacaktır	kazanad͡ʒaktɯɾ
kazanarak	kazanaɾak
kazanmak	kazanmak
kazanmayı	kazanmajɯ
kazanı	kazanɯ
kazanır	kazanɯɾ
kazların	kazlaɾɯn
kazlarını	kazlaɾɯnɯ
kaşla	kaʃla
kâğıdı	kâɰɯdɯ
kaşık	kaʃɯk
kâğıtlarına	kâɰɯtlaɾɯna
kaşığı	kaʃɯɰɯ
keçi	ket͡ʃi
kehanet	kehanet
kemiklerinden	kemikleɾinden
ken	ken
kenarına	kenaɾɯna
kenarında	kenaɾɯnda
kendi	kendi
kendilerine	kendileɾine
kendilerini	kendileɾini
kendilerinin	kendileɾinin
kendime	kendime
kendimi	kendimi
kendinden	kendinden
kendine	kendine
kendini	kendini
kendinizi	kendinizi
kendisi	kendisi
kendiside	kendiside
kendisine	kendisine
kendisini	kendisini
kentinin	kentinin
kentlerinden	kentleɾinden
kepek	kepek
kere	keɾe
keresinde	keɾesinde
kesildi	kesildi
kesilmeden	kesilmeden
kesiminde	kesiminde
kesimli	kesimli
kesin	kesin
kesinlikle	kesinlikle
kestikten	kestikten
kestirdiği	kestiɾdiɰi
keyifli	kejifli
kez	kez
keşfetti	keʃfetti
ki	ki
kiler	kileɾ
kilit	kilit
kilometre	kilometɾe
kim	kim
kimi	kimi
kimileri	kimileɾi
kimlik	kimlik
kimliksizliğe	kimliksizliɰe
kimliği	kimliɰi
kimliğine	kimliɰine
kimliğini	kimliɰini
kimse	kimse
kimselerin	kimseleɾin
kimselerle	kimseleɾle
kimsenin	kimsenin
kimya	kimja
kimyasal	kimjasal
kinden	kinden
kini	kini
kinle	kinle
kiracı	kiɾad͡ʒɯ
kirletilmemesine	kiɾletilmemesine
kirpiği	kiɾpiɰi
kitabı	kitabɯ
kitabıyım	kitabɯjɯm
kitap	kitap
kitaplara	kitaplaɾa
kitaplarda	kitaplaɾda
kitapları	kitaplaɾɯ
kitapların	kitaplaɾɯn
kitaplarını	kitaplaɾɯnɯ
kitlenin	kitlenin
kişi	kiʃi
kişiler	kiʃileɾ
kişilerle	kiʃileɾle
kişilik	kiʃilik
kişinin	kiʃinin
kişisel	kiʃisel
kişiyi	kiʃiji
kişiyle	kiʃijle
klasik	klasik
kocası	kod͡ʒasɯ
köhne	kœhne
kokacak	kokad͡ʒak
kökenli	kœkenli
kokladı	kokladɯ
kökleri	kœkleɾi
kokteyl	koktejl
kokuları	kokulaɾɯ
kokuyor	kokujoɾ
kol	kol
kolay	kolaj
kolaylaştıran	kolajlaʃtɯɾan
kolaylığı	kolajlɯɰɯ
köleliği	kœleliɰi
kolera	koleɾa
kollarından	kollaɾɯndan
koltuk	koltuk
kompleksi	kompleksi
kompleksidir	kompleksidiɾ
kömürleşmiş	kœmyɾleʃmiʃ
kongresini	konɡɾesini
konjonktürde	konʒonktyɾde
konması	konmasɯ
konserleri	konseɾleɾi
konservesi	konseɾvesi
kontrol	kontɾol
kontrolden	kontɾolden
konu	konu
konuk	konuk
konuklardan	konuklaɾdan
konulara	konulaɾa
konularda	konulaɾda
konularında	konulaɾɯnda
konuma	konuma
konusu	konusu
konusuyla	konusujla
konuyu	konuju
konuşacak	konuʃad͡ʒak
konuşacakmışız	konuʃad͡ʒakmɯʃɯz
konuşamadık	konuʃamadɯk
konuşamıyor	konuʃamɯjoɾ
konuşamıyordu	konuʃamɯjoɾdu
konuşma	konuʃma
konuşmada	konuʃmada
konuşmadan	konuʃmadan
konuşmak	konuʃmak
konuşması	konuʃmasɯ
konuşmasında	konuʃmasɯnda
konuşmasından	konuʃmasɯndan
konuşmaya	konuʃmaja
konuşmuyor	konuʃmujoɾ
konuştu	konuʃtu
konuştular	konuʃtulaɾ
konuğu	konuɰu
konuşun	konuʃun
konuşup	konuʃup
konuşurken	konuʃuɾken
konuşuyor	konuʃujoɾ
konuşuyorum	konuʃujoɾum
koparma	kopaɾma
köprüye	kœpɾyje
kopya	kopja
kopyalanmış	kopjalanmɯʃ
koreografileri	koɾeoɡɾafileɾi
korkan	koɾkan
korkağı	koɾkaɰɯ
korkmaz	koɾkmaz
korkunç	koɾkunt͡ʃ
korsanlığı	koɾsanlɯɰɯ
korumak	koɾumak
korumaların	koɾumalaɾɯn
korunma	koɾunma
korunması	koɾunmasɯ
korunmasını	koɾunmasɯnɯ
korunmaya	koɾunmaja
korurdu	koɾuɾdu
kot	kot
kötü	kœty
kötülük	kœtylyk
kovabiliyor	kovabilijoɾ
kovma	kovma
koyamıyor	kojamɯjoɾ
koyamıyordu	kojamɯjoɾdu
koydu	kojdu
köye	kœje
koymadan	kojmadan
koymuş	kojmuʃ
koyun	kojun
köyün	kœjyn
koş	koʃ
köşede	kœʃede
köşesini	kœʃesini
köşklerin	kœʃkleɾin
köşküne	kœʃkyne
koşu	koʃu
koşullarda	koʃullaɾda
koşulmuş	koʃulmuʃ
koşulmuştur	koʃulmuʃtuɾ
koğuşunu	koɰuʃunu
kral	kɾal
kralın	kɾalɯn
kredi	kɾedi
kredileri	kɾedileɾi
krema	kɾema
krize	kɾize
krizlerini	kɾizleɾini
kü	ky
kubbenin	kubbenin
kucaklayacak	kud͡ʒaklajad͡ʒak
kucaklayacaktır	kud͡ʒaklajad͡ʒaktɯɾ
küçücük	kyt͡ʃyd͡ʒyk
küçük	kyt͡ʃyk
küçüklere	kyt͡ʃykleɾe
küçüksün	kyt͡ʃyksyn
küçümsenmeyecek	kyt͡ʃymsenmejed͡ʒek
küfrün	kyfɾyn
kulak	kulak
kulağıma	kulaɰɯma
kulağımız	kulaɰɯmɯz
kulağımızla	kulaɰɯmɯzla
kullandı	kullandɯ
kullandın	kullandɯn
kullandığı	kullandɯɰɯ
kullandığımız	kullandɯɰɯmɯz
kullanma	kullanma
kullanmaktan	kullanmaktan
kullanması	kullanmasɯ
kullanmaya	kullanmaja
kullanıcıların	kullanɯd͡ʒɯlaɾɯn
kullanıcılarına	kullanɯd͡ʒɯlaɾɯna
kullanılacak	kullanɯlad͡ʒak
kullanılan	kullanɯlan
kullanılmış	kullanɯlmɯʃ
kullanılıyorsa	kullanɯlɯjoɾsa
kullanım	kullanɯm
kullanıp	kullanɯp
kullanıyoruz	kullanɯjoɾuz
kültür	kyltyɾ
kültürel	kyltyɾel
kültüründe	kyltyɾynde
kültürüyle	kyltyɾyjle
kumandalı	kumandalɯ
küme	kyme
kuracağız	kuɾad͡ʒaɰɯz
kurallarının	kuɾallaɾɯnɯn
kurbanları	kuɾbanlaɾɯ
kurbanı	kuɾbanɯ
kurdular	kuɾdulaɾ
kurduğunuz	kuɾduɰunuz
küresel	kyɾesel
kurgular	kuɾɡulaɾ
kurlarında	kuɾlaɾɯnda
kurmak	kuɾmak
kürsüde	kyɾsyde
kürt	kyɾt
kurtardınız	kuɾtaɾdɯnɯz
kurtuldu	kuɾtuldu
kurtulmalıyız	kuɾtulmalɯjɯz
kurtulmuş	kuɾtulmuʃ
kurtulmuştum	kuɾtulmuʃtum
kuru	kuɾu
kurul	kuɾul
kuruldu	kuɾuldu
kurulur	kuɾuluɾ
kuruluş	kuɾuluʃ
kurum	kuɾum
kurumlarını	kuɾumlaɾɯnɯ
kurumu	kuɾumu
kurun	kuɾun
kurye	kuɾje
kurşun	kuɾʃun
kutlamak	kutlamak
kutlamakla	kutlamakla
kutlamaları	kutlamalaɾɯ
kutlayan	kutlajan
kutlu	kutlu
kutluyor	kutlujoɾ
kutsal	kutsal
kutu	kutu
kutularla	kutulaɾla
kuvvetle	kuvvetle
kuvvetlendiriyordu	kuvvetlendiɾijoɾdu
kuvvetlerinden	kuvvetleɾinden
kuvvetli	kuvvetli
kuyruk	kujɾuk
kuyu	kuju
kuyusu	kujusu
kuşkonmaz	kuʃkonmaz
kuşku	kuʃku
kuşkulanmak	kuʃkulanmak
kuşkularla	kuʃkulaɾla
kuşlar	kuʃlaɾ
kuşları	kuʃlaɾɯ
kuşun	kuʃun
kuşüzümü	kuʃyzymy
kıç	kɯt͡ʃ
kıçı	kɯt͡ʃɯ
kılan	kɯlan
kılıyor	kɯlɯjoɾ
kılığına	kɯlɯɰɯna
kımıldamadı	kɯmɯldamadɯ
kır	kɯɾ
kıramam	kɯɾamam
kırması	kɯɾmasɯ
kırık	kɯɾɯk
kırın	kɯɾɯn
kısa	kɯsa
kısacık	kɯsad͡ʒɯk
kıskançlığın	kɯskant͡ʃlɯɰɯn
kıskanıyor	kɯskanɯjoɾ
kısmen	kɯsmen
kısmı	kɯsmɯ
kısmında	kɯsmɯnda
kıt	kɯt
kıtalara	kɯtalaɾa
kıvançsız	kɯvant͡ʃsɯz
kıvrılmasının	kɯvɾɯlmasɯnɯn
kıyımlara	kɯjɯmlaɾa
kıyın	kɯjɯn
kıyıya	kɯjɯja
kız	kɯz
kızdı	kɯzdɯ
kızdırmayalım	kɯzdɯɾmajalɯm
kızgın	kɯzɡɯn
kızı	kɯzɯ
kızımı	kɯzɯmɯ
kış	kɯʃ
kışlanın	kɯʃlanɯn
kışlaya	kɯʃlaja
lafları	laflaɾɯ
lâik	lâik
laiklik	laiklik
lâiktir	lâiktiɾ
lan	lan
lastik	lastik
lazım	lazɯm
lekeleri	lekeleɾi
lesbiyen	lesbijen
levha	levha
levhasında	levhasɯnda
lezzetlerinin	lezzetleɾinin
lezzetli	lezzetli
liberal	libeɾal
liberaldir	libeɾaldiɾ
lideri	lideɾi
liderini	lideɾini
lig	liɡ
ligde	liɡde
limitlerinin	limitleɾinin
limon	limon
liraya	liɾaja
lirayı	liɾajɯ
listede	listede
lütfen	lytfen
lı	lɯ
maç	mat͡ʃ
maçları	mat͡ʃlaɾɯ
maçlarında	mat͡ʃlaɾɯnda
maçlarından	mat͡ʃlaɾɯndan
maçlarını	mat͡ʃlaɾɯnɯ
maçta	mat͡ʃta
maçtan	mat͡ʃtan
madde	madde
maddeler	maddeleɾ
maddelere	maddeleɾe
maddelerin	maddeleɾin
maddelerine	maddeleɾine
maddelerinin	maddeleɾinin
maddesi	maddesi
maddeyi	maddeji
mafyalaşmış	mafjalaʃmɯʃ
magazin	maɡazin
mahalle	mahalle
mahalleye	mahalleje
mahkemeler	mahkemeleɾ
mahkûmları	mahkûmlaɾɯ
mahrum	mahɾum
makam	makam
makbul	makbul
makine	makine
makinelerin	makineleɾin
makinesine	makinesine
maksatlarla	maksatlaɾla
mal	mal
malumunuz	malumunuz
malzeme	malzeme
malzemelere	malzemeleɾe
malzemelerini	malzemeleɾini
malzemesi	malzemesi
maneviyata	manevijata
mankenler	mankenleɾ
mantar	mantaɾ
manzara	manzaɾa
manzaralı	manzaɾalɯ
marketten	maɾketten
mart	maɾt
martının	maɾtɯnɯn
masa	masa
masadan	masadan
masallar	masallaɾ
masanın	masanɯn
maskesine	maskesine
masonluk	masonluk
masum	masum
mavi	mavi
maviyle	mavijle
maydanoz	majdanoz
mayıs	majɯs
mayısından	majɯsɯndan
meçhul	met͡ʃhul
mecmualarında	med͡ʒmualaɾɯnda
medyasına	medjasɯna
mektebine	mektebine
mektup	mektup
memeleriyle	memeleɾijle
memleket	memleket
memlekete	memlekete
memleketleri	memleketleɾi
memleketleridir	memleketleɾidiɾ
memnunuz	memnunuz
memurluğu	memuɾluɰu
mensuplarıyla	mensuplaɾɯjla
merak	meɾak
meraklandırmadan	meɾaklandɯɾmadan
meraklı	meɾaklɯ
merakta	meɾakta
merhametli	meɾhametli
merkezi	meɾkezi
merkezini	meɾkezini
merkezinin	meɾkezinin
merkezleri	meɾkezleɾi
mermiyi	meɾmiji
mesafe	mesafe
mesafeli	mesafeli
mesaj	mesaʒ
mesajı	mesaʒɯ
mesajını	mesaʒɯnɯ
mesela	mesela
mesele	mesele
mesleki	mesleki
metodla	metodla
metre	metɾe
mevkiiniz	mevkiiniz
mevzilerinden	mevzileɾinden
meydana	mejdana
meyvedir	mejvediɾ
mezar	mezaɾ
mezarlarında	mezaɾlaɾɯnda
meziyeti	mezijeti
mezun	mezun
meşgul	meʃɡul
meşruluk	meʃɾuluk
mi	mi
millete	millete
milletlerin	milletleɾin
milli	milli
milliyetçilik	millijett͡ʃilik
milliyetçiliği	millijett͡ʃiliɰi
milyar	miljaɾ
milyon	miljon
milyona	miljona
milyonunu	miljonunu
mimari	mimaɾi
mimesis	mimesis
minik	minik
minör	minœɾ
mirepoix	miɾepoix
misiniz	misiniz
misojen	misoʒen
miydi	mijdi
miş	miʃ
moda	moda
model	model
modeller	modelleɾ
modern	modeɾn
montajı	montaʒɯ
motivasyona	motivasjona
motor	motoɾ
mu	mu
mü	my
muayene	muajene
mücadele	myd͡ʒadele
mücadelesi	myd͡ʒadelesi
mücevherat	myd͡ʒevheɾat
müdürlüklerinin	mydyɾlykleɾinin
müdürü	mydyɾy
mugayir	muɡajiɾ
muhabiri	muhabiɾi
muhacir	muhad͡ʒiɾ
muhaliflerin	muhalifleɾin
muhtarlığa	muhtaɾlɯɰa
muhteşem	muhteʃem
mukavemeti	mukavemeti
mükemmel	mykemmel
mükemmeldi	mykemmeldi
mükemmellik	mykemmellik
mukozanın	mukozanɯn
mümkün	mymkyn
mümkündür	mymkyndyɾ
mumluk	mumluk
mürettebatınız	myɾettebatɯnɯz
müsabakaya	mysabakaja
müslim	myslim
mutasarrıflık	mutasaɾɾɯflɯk
mütevazı	mytevazɯ
mutfağın	mutfaɰɯn
mutfağında	mutfaɰɯnda
mutfağının	mutfaɰɯnɯn
mutlaka	mutlaka
mutlu	mutlu
mutluluk	mutluluk
mutluluğu	mutluluɰu
mutsuz	mutsuz
müydü	myjdy
müzikler	myzikleɾ
muzip	muzip
müzisyenin	myzisjenin
müziği	myziɰi
müziğini	myziɰini
muş	muʃ
müşaviri	myʃaviɾi
mı	mɯ
mıdır	mɯdɯɾ
mırın	mɯɾɯn
mış	mɯʃ
mışız	mɯʃɯz
nakit	nakit
nakliyeci	naklijed͡ʒi
nanometre	nanometɾe
nasıl	nasɯl
naylon	najlon
nazar	nazaɾ
nazaran	nazaɾan
nazik	nazik
nde	nde
ne	ne
neden	neden
nedeni	nedeni
nedeniyle	nedenijle
nedenle	nedenle
nedenlerle	nedenleɾle
nedense	nedense
nedir	nediɾ
neferleri	nefeɾleɾi
neferlerisiniz	nefeɾleɾisiniz
nefes	nefes
nefret	nefɾet
nehirler	nehiɾleɾ
neler	neleɾ
nelerdir	neleɾdiɾ
nerede	neɾede
nereden	neɾeden
neredeyse	neɾedejse
neresi	neɾesi
nereye	neɾeje
nesnellikten	nesnellikten
net	net
neye	neje
nezaket	nezaket
neşelendi	neʃelendi
nice	nid͡ʒe
niçin	nit͡ʃin
nihai	nihai
nikâh	nikâh
niteliği	niteliɰi
niye	nije
nizamiyeden	nizamijeden
nişan	niʃan
noksanlı	noksanlɯ
noktada	noktada
noktaladı	noktaladɯ
noktası	noktasɯ
noktasına	noktasɯna
noktasında	noktasɯnda
noktaya	noktaja
normal	noɾmal
notta	notta
notun	notun
nüfuslu	nyfuslu
numaralı	numaɾalɯ
numaramı	numaɾamɯ
o	o
objektiflik	obʒektiflik
öbür	œbyɾ
ocak	od͡ʒak
ocağın	od͡ʒaɰɯn
oda	oda
odada	odada
odadan	odadan
odaklanıyor	odaklanɯjoɾ
odalar	odalaɾ
odalarında	odalaɾɯnda
odamda	odamda
odasına	odasɯna
odaya	odaja
odağında	odaɰɯnda
ödediği	œdediɰi
ödeme	œdeme
ödenek	œdenek
öder	œdeɾ
ödeyemediğinizi	œdejemediɰinizi
ödül	œdyl
ödün	œdyn
ögeler	œɡeleɾ
okka	okka
öksürmek	œksyɾmek
okuduğumu	okuduɰumu
okuluma	okuluma
okulunu	okulunu
okuma	okuma
okumaya	okumaja
okunan	okunan
okuttukları	okuttuklaɾɯ
okuyorlar	okujoɾlaɾ
okuyun	okujun
okyanuslar	okjanuslaɾ
okşadıktan	okʃadɯktan
ol	ol
olabileceklerini	olabiled͡ʒekleɾini
olabileceği	olabiled͡ʒeɰi
olabileceğim	olabiled͡ʒeɰim
olabilir	olabiliɾ
olabilmek	olabilmek
olacak	olad͡ʒak
olacaktı	olad͡ʒaktɯ
olacağı	olad͡ʒaɰɯ
olacağını	olad͡ʒaɰɯnɯ
olacağız	olad͡ʒaɰɯz
olamadı	olamadɯ
olamamış	olamamɯʃ
olamazlar	olamazlaɾ
olan	olan
olanak	olanak
olanlar	olanlaɾ
olanların	olanlaɾɯn
olarak	olaɾak
olası	olasɯ
olasılığını	olasɯlɯɰɯnɯ
olay	olaj
olaylar	olajlaɾ
olayları	olajlaɾɯ
ölçüde	œlt͡ʃyde
oldu	oldu
olduk	olduk
oldukları	olduklaɾɯ
olduklarından	olduklaɾɯndan
olduktan	olduktan
oldular	oldulaɾ
oldum	oldum
öldürdüğünü	œldyɾdyɰyny
öldüren	œldyɾen
öldürmek	œldyɾmek
öldürülen	œldyɾylen
olduysanız	oldujsanɯz
olduğu	olduɰu
olduğum	olduɰum
olduğumuz	olduɰumuz
olduğumuzu	olduɰumuzu
olduğuna	olduɰuna
olduğunu	olduɰunu
olduğunun	olduɰunun
olgu	olɡu
olma	olma
olmadan	olmadan
olmadıklarına	olmadɯklaɾɯna
olmadım	olmadɯm
olmadığı	olmadɯɰɯ
olmadığım	olmadɯɰɯm
olmadığını	olmadɯɰɯnɯ
olmak	olmak
olmakla	olmakla
olmaktan	olmaktan
olmaları	olmalaɾɯ
olmalarına	olmalaɾɯna
olmalı	olmalɯ
olmalıdır	olmalɯdɯɾ
olmamış	olmamɯʃ
olmamıştı	olmamɯʃtɯ
olmamıştır	olmamɯʃtɯɾ
olman	olman
olması	olmasɯ
olmasına	olmasɯna
olmasını	olmasɯnɯ
olmasıydı	olmasɯjdɯ
olmaya	olmaja
olmayabilirler	olmajabiliɾleɾ
olmayacak	olmajad͡ʒak
olmayacaksın	olmajad͡ʒaksɯn
olmayacaktı	olmajad͡ʒaktɯ
olmayacaktır	olmajad͡ʒaktɯɾ
olmayacağım	olmajad͡ʒaɰɯm
olmayan	olmajan
olmayıp	olmajɯp
olmaz	olmaz
olmazsa	olmazsa
ölmeden	œlmeden
olmuş	olmuʃ
ölmüş	œlmyʃ
ölmüştü	œlmyʃty
olmuştum	olmuʃtum
olmuştur	olmuʃtuɾ
olsa	olsa
olsan	olsan
olsaydım	olsajdɯm
olsun	olsun
olsunlar	olsunlaɾ
ölüm	œlym
olumlu	olumlu
olumsuz	olumsuz
ölümsüzleşiyor	œlymsyzleʃijoɾ
ölümün	œlymyn
olunan	olunan
olunca	olund͡ʒa
olunmalıdır	olunmalɯdɯɾ
olup	olup
olur	oluɾ
olursa	oluɾsa
olursak	oluɾsak
olurum	oluɾum
oluveriyor	oluveɾijoɾ
oluyor	olujoɾ
oluyordu	olujoɾdu
ölüyorlar	œlyjoɾlaɾ
ölüyorlarmış	œlyjoɾlaɾmɯʃ
oluşan	oluʃan
oluşmak	oluʃmak
oluşmasında	oluʃmasɯnda
oluşturan	oluʃtuɾan
oluşturduk	oluʃtuɾduk
oluşturma	oluʃtuɾma
oluşturmanızda	oluʃtuɾmanɯzda
oluşturulmalıdır	oluʃtuɾulmalɯdɯɾ
oluştururlar	oluʃtuɾuɾlaɾ
oluşturuyor	oluʃtuɾujoɾ
oluşturuyormuş	oluʃtuɾujoɾmuʃ
oluşumunda	oluʃumunda
ömrü	œmɾy
on	on
ona	ona
onbeş	onbeʃ
önce	œnd͡ʒe
önceden	œnd͡ʒeden
önceki	œnd͡ʒeki
öncesi	œnd͡ʒesi
öncesine	œnd͡ʒesine
önceye	œnd͡ʒeje
öncülüğünde	œnd͡ʒylyɰynde
onda	onda
önde	œnde
öne	œne
önem	œnem
önemli	œnemli
önemlisi	œnemlisi
önemliydi	œnemlijdi
önemsiz	œnemsiz
önerdim	œneɾdim
önerir	œneɾiɾ
önerisine	œneɾisine
önerisinin	œneɾisinin
onlar	onlaɾ
onlara	onlaɾa
onları	onlaɾɯ
onların	onlaɾɯn
önlük	œnlyk
önlüyor	œnlyjoɾ
onu	onu
onun	onun
onuncu	onund͡ʒu
önünde	œnynde
önündeki	œnyndeki
önündeydi	œnyndejdi
önüne	œnyne
onunla	onunla
onur	onuɾ
onuruna	onuɾuna
öpmek	œpmek
orada	oɾada
oradan	oɾadan
orak	oɾak
oralarda	oɾalaɾda
oranla	oɾanla
orasının	oɾasɯnɯn
ordu	oɾdu
ordusu	oɾdusu
organizasyondan	oɾɡanizasjondan
organizasyonlara	oɾɡanizasjonlaɾa
organı	oɾɡanɯ
örgütlemek	œɾɡytlemek
ormanı	oɾmanɯ
örnek	œɾnek
örnekler	œɾnekleɾ
örnekleri	œɾnekleɾi
örnekleridir	œɾnekleɾidiɾ
örnekleriyle	œɾnekleɾijle
orta	oɾta
ortaçağ	oɾtat͡ʃaɰ
ortadan	oɾtadan
ortak	oɾtak
ortalık	oɾtalɯk
ortalığa	oɾtalɯɰa
ortalığı	oɾtalɯɰɯ
ortamda	oɾtamda
ortaöğretimi	oɾtaœɰɾetimi
ortasına	oɾtasɯna
ortasında	oɾtasɯnda
ortaya	oɾtaja
örtebildiğini	œɾtebildiɰini
örtülü	œɾtyly
örtüsü	œɾtysy
öteki	œteki
ötekinde	œtekinde
ötekine	œtekine
oto	oto
otobüsü	otobysy
otobüsün	otobysyn
otomobillerin	otomobilleɾin
oturan	otuɾan
oturanlarla	otuɾanlaɾla
oturdular	otuɾdulaɾ
oturduğu	otuɾduɰu
oturduğunuz	otuɾduɰunuz
oturma	otuɾma
oturmadığı	otuɾmadɯɰɯ
oturttu	otuɾttu
oturtulacaksa	otuɾtulad͡ʒaksa
oturup	otuɾup
övünüyoruz	œvynyjoɾuz
öykü	œjky
öykücülüğün	œjkyd͡ʒylyɰyn
öyküler	œjkyleɾ
öyküsüyle	œjkysyjle
öyküye	œjkyje
öyle	œjle
oyluğun	ojluɰun
oynamıyorsunuz	ojnamɯjoɾsunuz
oynanır	ojnanɯɾ
oynarken	ojnaɾken
oynattığında	ojnattɯɰɯnda
oynayabilir	ojnajabiliɾ
oynayacağımız	ojnajad͡ʒaɰɯmɯz
oynayacağını	ojnajad͡ʒaɰɯnɯ
oynuyor	ojnujoɾ
oyun	ojun
oyuncak	ojund͡ʒak
oyuncu	ojund͡ʒu
oyuncular	ojund͡ʒulaɾ
oyuncuların	ojund͡ʒulaɾɯn
oyunu	ojunu
oyunun	ojunun
oyunuyla	ojunujla
özel	œzel
özellik	œzellik
özellikle	œzellikle
özellikleri	œzellikleɾi
özelliği	œzelliɰi
özelliğiniz	œzelliɰiniz
özelliğinizdir	œzelliɰinizdiɾ
özen	œzen
özerk	œzeɾk
özetleyen	œzetlejen
özetliyor	œzetlijoɾ
özgü	œzɡy
özgün	œzɡyn
özgürlükleri	œzɡyɾlykleɾi
özürlülere	œzyɾlyleɾe
öğle	œɰle
oğluna	oɰluna
öğrenci	œɰɾend͡ʒi
öğrencileri	œɰɾend͡ʒileɾi
öğrencilerimizin	œɰɾend͡ʒileɾimizin
öğrencinin	œɰɾend͡ʒinin
öğrencisine	œɰɾend͡ʒisine
öğrenciyken	œɰɾend͡ʒijken
öğrenelim	œɰɾenelim
öğrenilmesi	œɰɾenilmesi
öğrenip	œɰɾenip
öğreteceksin	œɰɾeted͡ʒeksin
öğretmeni	œɰɾetmeni
öğretmenlik	œɰɾetmenlik
pahalı	pahalɯ
pahalıya	pahalɯja
paket	paket
pantolonunu	pantolonunu
para	paɾa
paralar	paɾalaɾ
paraları	paɾalaɾɯ
paraların	paɾalaɾɯn
parasız	paɾasɯz
paraya	paɾaja
parça	paɾt͡ʃa
parçalara	paɾt͡ʃalaɾa
parçaları	paɾt͡ʃalaɾɯ
parçası	paɾt͡ʃasɯ
parlak	paɾlak
parlaktır	paɾlaktɯɾ
parmak	paɾmak
partiküllerden	paɾtikylleɾden
partinin	paɾtinin
partisi	paɾtisi
partiyle	paɾtijle
partneri	paɾtneɾi
patates	patates
patikalarda	patikalaɾda
patlamalara	patlamalaɾa
patlatması	patlatmasɯ
patronu	patɾonu
paylaşan	pajlaʃan
paylaşmaktadır	pajlaʃmaktadɯɾ
paylaşmaya	pajlaʃmaja
paylaşın	pajlaʃɯn
paylaşınız	pajlaʃɯnɯz
paylaşıyoruz	pajlaʃɯjoɾuz
pazarlarda	pazaɾlaɾda
pazarları	pazaɾlaɾɯ
pazarına	pazaɾɯna
pc	pd͡ʒ
pedagog	pedaɡoɡ
pek	pek
peki	peki
pekiştirme	pekiʃtiɾme
pembe	pembe
penisin	penisin
perakende	peɾakende
performansından	peɾfoɾmansɯndan
perisi	peɾisi
perişan	peɾiʃan
pervasız	peɾvasɯz
petrol	petɾol
peşinde	peʃinde
peşindedir	peʃindediɾ
peşindeydi	peʃindejdi
peşine	peʃine
peşkeş	peʃkeʃ
peşmergelerin	peʃmeɾɡeleɾin
pirinç	piɾint͡ʃ
pis	pis
piyanist	pijanist
piyanoda	pijanoda
piyasasında	pijasasɯnda
piyasaya	pijasaja
piyesinde	pijesinde
pişirilmesini	piʃiɾilmesini
plan	plan
planlıyor	planlɯjoɾ
polisi	polisi
pomak	pomak
pop	pop
popüler	popyleɾ
posta	posta
pozisyonda	pozisjonda
pozisyonuna	pozisjonuna
problemleri	pɾoblemleɾi
profesörü	pɾofesœɾy
program	pɾoɡɾam
proje	pɾoʒe
projeyi	pɾoʒeji
protesto	pɾotesto
provakosyana	pɾovakosjana
psikolog	psikoloɡ
psikolojik	psikoloʒik
psiyografik	psijoɡɾafik
puan	puan
puroyu	puɾoju
pırasa	pɯɾasa
pırıltı	pɯɾɯltɯ
radyo	ɾadjo
raf	ɾaf
rahat	ɾahat
rahatlamış	ɾahatlamɯʃ
rahatlamıştık	ɾahatlamɯʃtɯk
rahatsızlık	ɾahatsɯzlɯk
rakamlarda	ɾakamlaɾda
rakipler	ɾakipleɾ
rakı	ɾakɯ
raporunu	ɾapoɾunu
raylı	ɾajlɯ
rağmen	ɾaɰmen
realite	ɾealite
realitedir	ɾealitediɾ
reçete	ɾet͡ʃete
reddedilmiş	ɾeddedilmiʃ
reel	ɾeel
reelin	ɾeelin
referans	ɾefeɾans
rehabilite	ɾehabilite
rehber	ɾehbeɾ
reklam	ɾeklam
reklamlar	ɾeklamlaɾ
rendelenmiş	ɾendelenmiʃ
rengimde	ɾenɡimde
rengimdeydi	ɾenɡimdejdi
renk	ɾenk
renklerden	ɾenkleɾden
renkleri	ɾenkleɾi
renkli	ɾenkli
resimlerin	ɾesimleɾin
resmi	ɾesmi
ret	ɾet
retrospektifini	ɾetɾospektifini
risk	ɾisk
rol	ɾol
rollere	ɾolleɾe
rollerini	ɾolleɾini
romancının	ɾomand͡ʒɯnɯn
romandan	ɾomandan
romanlarda	ɾomanlaɾda
romantik	ɾomantik
romanı	ɾomanɯ
romanın	ɾomanɯn
romanında	ɾomanɯnda
romanındaki	ɾomanɯndaki
romanınıza	ɾomanɯnɯza
ruh	ɾuh
ruhu	ɾuhu
ruhunda	ɾuhunda
rütbeli	ɾytbeli
rüzgâr	ɾyzɡâɾ
rüzgâra	ɾyzɡâɾa
rüzgârda	ɾyzɡâɾda
rüzgârlar	ɾyzɡâɾlaɾ
sa	sa
saat	saat
saatleri	saatleɾi
saatlerinde	saatleɾinde
saatte	saatte
saatımızdan	saatɯmɯzdan
sabah	sabah
sabaha	sabaha
sabahleyin	sabahlejin
sabahı	sabahɯ
sabit	sabit
sabitleniyor	sabitlenijoɾ
sabunlu	sabunlu
saç	sat͡ʃ
sacdan	sad͡ʒdan
saçlı	sat͡ʃlɯ
saçma	sat͡ʃma
saçı	sat͡ʃɯ
sadece	saded͡ʒe
sadeleştirilmesi	sadeleʃtiɾilmesi
safhada	safhada
safi	safi
sahada	sahada
sahibi	sahibi
sahip	sahip
sahipleri	sahipleɾi
sahneye	sahneje
sahte	sahte
sakin	sakin
sakladım	sakladɯm
saklamaya	saklamaja
saklanıyor	saklanɯjoɾ
saldırması	saldɯɾmasɯ
saldırı	saldɯɾɯ
salgın	salɡɯn
salnamelerde	salnameleɾde
salnamelerdeki	salnameleɾdeki
salon	salon
salonu	salonu
salt	salt
salı	salɯ
sam	sam
sana	sana
sanabiliyoruz	sanabilijoɾuz
sanal	sanal
sanalda	sanalda
sanaldaki	sanaldaki
sanatçı	sanatt͡ʃɯ
sanatçılar	sanatt͡ʃɯlaɾ
sanatseverlere	sanatseveɾleɾe
sanatın	sanatɯn
sanayi	sanaji
sanayileşme	sanajileʃme
sanayimiz	sanajimiz
sancak	sand͡ʒak
sancılı	sand͡ʒɯlɯ
sandaletler	sandaletleɾ
sandalyeler	sandaljeleɾ
saniyeler	sanijeleɾ
sanki	sanki
sanmış	sanmɯʃ
sanmıştım	sanmɯʃtɯm
santimetre	santimetɾe
santimetrelik	santimetɾelik
sanıklar	sanɯklaɾ
sanıp	sanɯp
saplarını	saplaɾɯnɯ
sapmalar	sapmalaɾ
saptadı	saptadɯ
sar	saɾ
sarar	saɾaɾ
sararıp	saɾaɾɯp
sarı	saɾɯ
sarıkatran	saɾɯkatɾan
sarıldı	saɾɯldɯ
sarılmak	saɾɯlmak
sarısı	saɾɯsɯ
satan	satan
satar	sataɾ
satardık	sataɾdɯk
satm	satm
satıcı	satɯd͡ʒɯ
satın	satɯn
satır	satɯɾ
satışlar	satɯʃlaɾ
savaş	savaʃ
savaşan	savaʃan
savaşmanın	savaʃmanɯn
savunacaklarını	savunad͡ʒaklaɾɯnɯ
savunmasına	savunmasɯna
savunmaya	savunmaja
savunur	savunuɾ
sayarız	sajaɾɯz
saydılar	sajdɯlaɾ
sayede	sajede
sayesinde	sajesinde
sayfalık	sajfalɯk
sayfasına	sajfasɯna
sayfasını	sajfasɯnɯ
saygı	sajɡɯ
saygısızlık	sajɡɯsɯzlɯk
sayılabilecek	sajɯlabiled͡ʒek
sayılamayacağını	sajɯlamajad͡ʒaɰɯnɯ
sayın	sajɯn
sayısal	sajɯsal
sayısı	sajɯsɯ
sayısını	sajɯsɯnɯ
sayıya	sajɯja
sağ	saɰ
sağa	saɰa
sağlam	saɰlam
sağlamadığını	saɰlamadɯɰɯnɯ
sağlamak	saɰlamak
sağlaması	saɰlamasɯ
sağlamasıdır	saɰlamasɯdɯɾ
sağlamlığı	saɰlamlɯɰɯ
sağlanamayacağını	saɰlanamajad͡ʒaɰɯnɯ
sağlanmasında	saɰlanmasɯnda
sağlanmaya	saɰlanmaja
sağlanır	saɰlanɯɾ
sağlar	saɰlaɾ
sağlayamadığını	saɰlajamadɯɰɯnɯ
sağlayan	saɰlajan
sağlayarak	saɰlajaɾak
sağlıkla	saɰlɯkla
sağlıklı	saɰlɯklɯ
sağlıyor	saɰlɯjoɾ
sağlığı	saɰlɯɰɯ
sağlığının	saɰlɯɰɯnɯn
sağlığınıza	saɰlɯɰɯnɯza
se	se
sebebi	sebebi
sebep	sebep
sebepleri	sebepleɾi
sebze	sebze
sebzelerin	sebzeleɾin
seçeneğin	set͡ʃeneɰin
seçilmiş	set͡ʃilmiʃ
seçime	set͡ʃime
seçimi	set͡ʃimi
seçimlerde	set͡ʃimleɾde
seçimlerden	set͡ʃimleɾden
seçimlerinden	set͡ʃimleɾinden
seçtiği	set͡ʃtiɰi
secular	sed͡ʒulaɾ
sefaletlerinin	sefaletleɾinin
sekreter	sekɾeteɾ
sektör	sektœɾ
sektörel	sektœɾel
sektörünü	sektœɾyny
seminerinde	semineɾinde
semtlerine	semtleɾine
sen	sen
senaryoların	senaɾjolaɾɯn
sene	sene
senet	senet
seni	seni
senin	senin
sentez	sentez
sepetlerle	sepetleɾle
serbest	seɾbest
sergiden	seɾɡiden
sergileyenler	seɾɡilejenleɾ
sergisini	seɾɡisini
sermaye	seɾmaje
serpip	seɾpip
sert	seɾt
sertliği	seɾtliɰi
serüveni	seɾyveni
servis	seɾvis
servisine	seɾvisine
ses	ses
sesi	sesi
sesleniyorlar	seslenijoɾlaɾ
sessiz	sessiz
sessizliğine	sessizliɰine
sevdiklerini	sevdikleɾini
sevdiği	sevdiɰi
sevdiğim	sevdiɰim
sevdiğinden	sevdiɰinden
sevebilir	sevebiliɾ
seven	seven
sever	seveɾ
severler	seveɾleɾ
sevgi	sevɡi
sevginin	sevɡinin
sevgisi	sevɡisi
sevgisinden	sevɡisinden
sevgiyle	sevɡijle
sevimli	sevimli
seviyede	sevijede
seviyor	sevijoɾ
sevişmeden	seviʃmeden
sevk	sevk
sevmeyip	sevmejip
sevsin	sevsin
seyahatlerde	sejahatleɾde
seyirci	sejiɾd͡ʒi
seyircimizle	sejiɾd͡ʒimizle
seyri	sejɾi
seyyar	sejjaɾ
sezgisel	sezɡisel
sezon	sezon
seğirtiyorum	seɰiɾtijoɾum
silahlarını	silahlaɾɯnɯ
sildim	sildim
sileceğini	siled͡ʒeɰini
silkinip	silkinip
simsiyah	simsijah
sinirliliğini	siniɾliliɰini
siniz	siniz
sinmiş	sinmiʃ
sipariş	sipaɾiʃ
sirke	siɾke
sisler	sisleɾ
sistematik	sistematik
sistemi	sistemi
sistemimizin	sistemimizin
sistemin	sistemin
sistemini	sistemini
sistemlere	sistemleɾe
sistemli	sistemli
sivil	sivil
siyahların	sijahlaɾɯn
siyaset	sijaset
siyasetçi	sijasett͡ʃi
siyasetçiydi	sijasett͡ʃijdi
siyaseti	sijaseti
siyasi	sijasi
siz	siz
size	size
sizi	sizi
sizin	sizin
sizinle	sizinle
skoru	skoɾu
sohbet	sohbet
sohbetleri	sohbetleɾi
sokakta	sokakta
sokağın	sokaɰɯn
sokmadı	sokmadɯ
sokulmaya	sokulmaja
sol	sol
sola	sola
solcular	sold͡ʒulaɾ
solduğunu	solduɰunu
solucanlarının	solud͡ʒanlaɾɯnɯn
somut	somut
somutlaşır	somutlaʃɯɾ
son	son
sonlarında	sonlaɾɯnda
sonra	sonɾa
sonradan	sonɾadan
sonraları	sonɾalaɾɯ
sonrası	sonɾasɯ
sonuç	sonut͡ʃ
sonuçlarına	sonut͡ʃlaɾɯna
sonucu	sonud͡ʒu
sonunda	sonunda
sorar	soɾaɾ
sorgulanan	soɾɡulanan
sorma	soɾma
sormuşlar	soɾmuʃlaɾ
soru	soɾu
sorular	soɾulaɾ
sorulardı	soɾulaɾdɯ
sorumluluklarım	soɾumluluklaɾɯm
sorun	soɾun
sorunlar	soɾunlaɾ
sorunları	soɾunlaɾɯ
sorunlarının	soɾunlaɾɯnɯn
sorunu	soɾunu
soruya	soɾuja
soruyor	soɾujoɾ
sos	sos
soslarına	soslaɾɯna
sosyal	sosjal
sosyalizmi	sosjalizmi
sosyo	sosjo
sosyolojik	sosjoloʒik
soykırımın	sojkɯɾɯmɯn
söyledi	sœjledi
söylediklerime	sœjledikleɾime
söyledim	sœjledim
söylediği	sœjlediɰi
söylemedim	sœjlemedim
söylemeyin	sœjlemejin
söylendi	sœjlendi
söylenen	sœjlenen
söylenir	sœjleniɾ
söyleyecek	sœjlejed͡ʒek
söyleyeceklerini	sœjlejed͡ʒekleɾini
söyleyecekmiş	sœjlejed͡ʒekmiʃ
söyleyelim	sœjlejelim
söyleşide	sœjleʃide
söyliyeyim	sœjlijejim
söylüyor	sœjlyjoɾ
söylüyorum	sœjlyjoɾum
soyu	soju
soyun	sojun
soyunma	sojunma
soyunup	sojunup
soyup	sojup
söz	sœz
sözde	sœzde
sözle	sœzle
sözlerine	sœzleɾine
sözlerini	sœzleɾini
sözleriyle	sœzleɾijle
sözlerle	sœzleɾle
sözleşme	sœzleʃme
sözlü	sœzly
sözü	sœzy
soğan	soɰan
soğuğu	soɰuɰu
sperm	speɾm
spor	spoɾ
spotların	spotlaɾɯn
stadla	stadla
stratejik	stɾateʒik
stresin	stɾesin
su	su
subaylar	subajlaɾ
subayı	subajɯ
suçlamaların	sut͡ʃlamalaɾɯn
sularda	sulaɾda
suları	sulaɾɯ
sularıyla	sulaɾɯjla
sulu	sulu
sün	syn
sunacak	sunad͡ʒak
sunarak	sunaɾak
süpernova	sypeɾnova
süpürge	sypyɾɡe
süre	syɾe
sürebileceğine	syɾebiled͡ʒeɰine
süreç	syɾet͡ʃ
süreci	syɾed͡ʒi
sürecinde	syɾed͡ʒinde
süreçler	syɾet͡ʃleɾ
süreçlerdir	syɾet͡ʃleɾdiɾ
sürede	syɾede
süredir	syɾediɾ
sürekli	syɾekli
süren	syɾen
sürerken	syɾeɾken
sürmek	syɾmek
sürmekte	syɾmekte
sürmüş	syɾmyʃ
sürmüştü	syɾmyʃty
sürpriz	syɾpɾiz
sürü	syɾy
sürücüleri	syɾyd͡ʒyleɾi
sürüklediğini	syɾyklediɰini
sürüp	syɾyp
sürüşü	syɾyʃy
süryani	syɾjani
süs	sys
süslemişler	syslemiʃleɾ
süslemişlerdi	syslemiʃleɾdi
süslü	sysly
susmak	susmak
susturarak	sustuɾaɾak
susturur	sustuɾuɾ
susuzluğun	susuzluɰun
süt	syt
suya	suja
suyu	suju
suyun	sujun
suyunu	sujunu
suyunun	sujunun
suyuyla	sujujla
süzdürünüz	syzdyɾynyz
sıcak	sɯd͡ʒak
sıcaklığı	sɯd͡ʒaklɯɰɯ
sıcaklığını	sɯd͡ʒaklɯɰɯnɯ
sıcağı	sɯd͡ʒaɰɯ
sıçradığı	sɯt͡ʃɾadɯɰɯ
sık	sɯk
sıkılıyor	sɯkɯlɯjoɾ
sıkıntı	sɯkɯntɯ
sıkıntının	sɯkɯntɯnɯn
sıkıntısı	sɯkɯntɯsɯ
sınadıkları	sɯnadɯklaɾɯ
sınavda	sɯnavda
sınavlarında	sɯnavlaɾɯnda
sınavından	sɯnavɯndan
sınıflandırmış	sɯnɯflandɯɾmɯʃ
sınıfta	sɯnɯfta
sınırlarını	sɯnɯɾlaɾɯnɯ
sınırsız	sɯnɯɾsɯz
sıra	sɯɾa
sırada	sɯɾada
sıradan	sɯɾadan
sıraladı	sɯɾaladɯ
sıralamayı	sɯɾalamajɯ
sıralar	sɯɾalaɾ
sırasında	sɯɾasɯnda
sırasıyla	sɯɾasɯjla
sırrı	sɯɾɾɯ
sırtlarına	sɯɾtlaɾɯna
sıvı	sɯvɯ
sıyırın	sɯjɯɾɯn
sığdırabilmek	sɯɰdɯɾabilmek
ta	ta
tabak	tabak
tabakla	tabakla
tabii	tabii
tabloda	tabloda
taç	tat͡ʃ
tacı	tad͡ʒɯ
tadı	tadɯ
tahmini	tahmini
tahminlerini	tahminleɾini
tahrik	tahɾik
tahsil	tahsil
takarak	takaɾak
takdir	takdiɾ
takdirde	takdiɾde
takip	takip
taksitini	taksitini
taktik	taktik
takılan	takɯlan
takım	takɯm
takıma	takɯma
takımları	takɯmlaɾɯ
takımlarından	takɯmlaɾɯndan
takımlarıyla	takɯmlaɾɯjla
takımın	takɯmɯn
takımının	takɯmɯnɯn
talan	talan
talebesine	talebesine
talebiyle	talebijle
talep	talep
talihsiz	talihsiz
tam	tam
tamamen	tamamen
tamamladı	tamamladɯ
tamamlanamayan	tamamlanamajan
tamir	tamiɾ
tamirhanesi	tamiɾhanesi
tane	tane
tansiyonu	tansijonu
tanıdım	tanɯdɯm
tanık	tanɯk
tanıma	tanɯma
tanımadığım	tanɯmadɯɰɯm
tanımakta	tanɯmakta
tanımlaması	tanɯmlamasɯ
tanımlamıyor	tanɯmlamɯjoɾ
tanımları	tanɯmlaɾɯ
tanınacağı	tanɯnad͡ʒaɰɯ
tanısaydınız	tanɯsajdɯnɯz
tanıtan	tanɯtan
tanıtılır	tanɯtɯlɯɾ
tanışma	tanɯʃma
tanışmam	tanɯʃmam
tanıştığımız	tanɯʃtɯɰɯmɯz
tanışıklığım	tanɯʃɯklɯɰɯm
taraf	taɾaf
tarafa	taɾafa
tarafında	taɾafɯnda
tarafındaki	taɾafɯndaki
tarafından	taɾafɯndan
tarçın	taɾt͡ʃɯn
tarifler	taɾifleɾ
tariflerinin	taɾifleɾinin
tarih	taɾih
tarihinde	taɾihinde
tarihine	taɾihine
tarihinin	taɾihinin
tarihsel	taɾihsel
tarihten	taɾihten
tarzları	taɾzlaɾɯ
tarım	taɾɯm
tarımının	taɾɯmɯnɯn
tarıyorsunuz	taɾɯjoɾsunuz
tasalarını	tasalaɾɯnɯ
tasarlattı	tasaɾlattɯ
tasarrufu	tasaɾɾufu
tasavvufu	tasavvufu
taslakta	taslakta
tatilde	tatilde
tatillerde	tatilleɾde
tatlı	tatlɯ
tavır	tavɯɾ
tavırların	tavɯɾlaɾɯn
tayini	tajini
taze	taze
tazminat	tazminat
taş	taʃ
taşlarının	taʃlaɾɯnɯn
taştan	taʃtan
taşıma	taʃɯma
taşımaktan	taʃɯmaktan
taşındı	taʃɯndɯ
taşınıldığında	taʃɯnɯldɯɰɯnda
taşınırdı	taʃɯnɯɾdɯ
taşır	taʃɯɾ
taşırım	taʃɯɾɯm
taşıyacak	taʃɯjad͡ʒak
taşıyan	taʃɯjan
taşıyarak	taʃɯjaɾak
tedavi	tedavi
tedbirler	tedbiɾleɾ
tedbirlerini	tedbiɾleɾini
tedirgin	tediɾɡin
teferruat	tefeɾɾuat
tehlike	tehlike
tehlikesi	tehlikesi
tehlikeye	tehlikeje
tek	tek
tekerlekler	tekeɾlekleɾ
tekerleklerin	tekeɾlekleɾin
teklifi	teklifi
tekne	tekne
teknede	teknede
teknedeki	teknedeki
tekneler	tekneleɾ
teknenin	teknenin
tekneyse	teknejse
teknik	teknik
tekrar	tekɾaɾ
tekstil	tekstil
telaşına	telaʃɯna
telefonu	telefonu
televizyonu	televizjonu
teması	temasɯ
temel	temel
temeline	temeline
temelini	temelini
temiz	temiz
temizledikten	temizledikten
temizlendikten	temizlendikten
temizleyip	temizlejip
temposunda	temposunda
tencerede	tend͡ʒeɾede
teneke	teneke
teorize	teoɾize
tepeden	tepeden
tepelerinde	tepeleɾinde
tepki	tepki
tepkilerinden	tepkileɾinden
tepkime	tepkime
tercih	teɾd͡ʒih
tercihime	teɾd͡ʒihime
tereyağ	teɾejaɰ
tereyağı	teɾejaɰɯ
terk	teɾk
terkedeceğini	teɾkeded͡ʒeɰini
teröristlerin	teɾœɾistleɾin
tersinedir	teɾsinediɾ
teslim	teslim
test	test
testlerde	testleɾde
testleri	testleɾi
tezcanlı	tezd͡ʒanlɯ
tezkerenin	tezkeɾenin
teşekkür	teʃekkyɾ
teşekkürü	teʃekkyɾy
teşhirinin	teʃhiɾinin
teşkil	teʃkil
teşviki	teʃviki
ti	ti
tik	tik
tim	tim
tir	tiɾ
tiraj	tiɾaʒ
titizlik	titizlik
tiyatro	tijatɾo
tişört	tiʃœɾt
tohum	tohum
tohumun	tohumun
ton	ton
tonunuzu	tonunuzu
top	top
topaç	topat͡ʃ
topacım	topad͡ʒɯm
toparlamaya	topaɾlamaja
topladık	topladɯk
toplam	toplam
toplama	toplama
toplamamıştır	toplamamɯʃtɯɾ
toplanan	toplanan
toplantıda	toplantɯda
toplantısı	toplantɯsɯ
toplantısında	toplantɯsɯnda
toplantısının	toplantɯsɯnɯn
topların	toplaɾɯn
topluluk	topluluk
toplum	toplum
topluma	topluma
toplumlu	toplumlu
toplumsal	toplumsal
toprak	topɾak
topraklara	topɾaklaɾa
toprakları	topɾaklaɾɯ
toprakta	topɾakta
topraktaki	topɾaktaki
toprağa	topɾaɰa
topunun	topunun
torbaya	toɾbaja
tozu	tozu
trafiği	tɾafiɰi
travestilerle	tɾavestileɾle
trendleri	tɾendleɾi
treni	tɾeni
tsunami	tsunami
tu	tu
tü	ty
tüketiciler	tyketid͡ʒileɾ
tüketim	tyketim
tükürüverir	tykyɾyveɾiɾ
tum	tum
tüm	tym
tümü	tymy
tümüne	tymyne
tümüyle	tymyjle
tünel	tynel
tur	tuɾ
tür	tyɾ
turaç	tuɾat͡ʃ
turist	tuɾist
türküler	tyɾkyleɾ
türküsünde	tyɾkysynde
türlü	tyɾly
türlüsünün	tyɾlysynyn
tutabilirsiniz	tutabiliɾsiniz
tutacağım	tutad͡ʒaɰɯm
tutan	tutan
tutarı	tutaɾɯ
tutkuyla	tutkujla
tutmaktadır	tutmaktadɯɾ
tuttum	tuttum
tutturan	tuttuɾan
tutulduğunun	tutulduɰunun
tutum	tutum
tutup	tutup
tutuyorlar	tutujoɾlaɾ
tutuyorlardı	tutujoɾlaɾdɯ
tuvalet	tuvalet
tuz	tuz
tı	tɯ
tık	tɯk
tıkaması	tɯkamasɯ
tım	tɯm
tımarhaneye	tɯmaɾhaneje
tır	tɯɾ
üç	yt͡ʃ
uçakların	ut͡ʃaklaɾɯn
uçağı	ut͡ʃaɰɯ
ücretsiz	yd͡ʒɾetsiz
uçtan	ut͡ʃtan
uçtuğunu	ut͡ʃtuɰunu
uçuk	ut͡ʃuk
üçüncü	yt͡ʃynd͡ʒy
uçurtma	ut͡ʃuɾtma
uçuş	ut͡ʃuʃ
uçuşuyor	ut͡ʃuʃujoɾ
ufak	ufak
ufaklık	ufaklɯk
ulaşmıştır	ulaʃmɯʃtɯɾ
ulaştık	ulaʃtɯk
ulaştığı	ulaʃtɯɰɯ
ulaşılamazsa	ulaʃɯlamazsa
ulaşımın	ulaʃɯmɯn
ulaşıyorlarmış	ulaʃɯjoɾlaɾmɯʃ
ülke	ylke
ülkede	ylkede
ülkeleri	ylkeleɾi
ülkelerin	ylkeleɾin
ülkelerinden	ylkeleɾinden
ülkemiz	ylkemiz
ülkemizin	ylkemizin
ülkenin	ylkenin
ülkenizin	ylkenizin
ülkesi	ylkesi
ulusal	ulusal
uluslar	uluslaɾ
uluslararası	uluslaɾaɾasɯ
uluslarına	uluslaɾɯna
umarım	umaɾɯm
ümidiyle	ymidijle
umursamaz	umuɾsamaz
umutsuzluğa	umutsuzluɰa
üne	yne
üniforma	ynifoɾma
üniformamı	ynifoɾmamɯ
üniversite	yniveɾsite
üniversitede	yniveɾsitede
üniversitedeki	yniveɾsitedeki
üniversiteye	yniveɾsiteje
ünlü	ynly
unsuru	unsuɾu
unutmuşsunuz	unutmuʃsunuz
unuttun	unuttun
unutup	unutup
üre	yɾe
üreticisinin	yɾetid͡ʒisinin
üretildiği	yɾetildiɰi
üretilmeye	yɾetilmeje
üretim	yɾetim
üretimi	yɾetimi
üretimin	yɾetimin
üretiminde	yɾetiminde
üretmek	yɾetmek
ürkünç	yɾkynt͡ʃ
ürkütücü	yɾkytyd͡ʒy
ürünleri	yɾynleɾi
ürünleridir	yɾynleɾidiɾ
ürünlerin	yɾynleɾin
üst	yst
üstlenmekten	ystlenmekten
üstü	ysty
üstüme	ystyme
üstünde	ystynde
üstüne	ystyne
üstüydü	ystyjdy
utangaç	utanɡat͡ʃ
utangaçtı	utanɡat͡ʃtɯ
utanıp	utanɯp
ütülemeyen	ytylemejen
uyandıracak	ujandɯɾad͡ʒak
uyandıracaktır	ujandɯɾad͡ʒaktɯɾ
uyanmayacağımızı	ujanmajad͡ʒaɰɯmɯzɯ
uyar	ujaɾ
uyardı	ujaɾdɯ
uyarı	ujaɾɯ
uyarıcıyı	ujaɾɯd͡ʒɯjɯ
uyarısında	ujaɾɯsɯnda
üye	yje
üyelerin	yjeleɾin
üyelerinin	yjeleɾinin
uygarlık	ujɡaɾlɯk
uygulamasının	ujɡulamasɯnɯn
uygulanabilirliği	ujɡulanabiliɾliɰi
uygulanan	ujɡulanan
uygulayan	ujɡulajan
uygun	ujɡun
uygunu	ujɡunu
uyku	ujku
uyu	uju
uyumlaştırılmasını	ujumlaʃtɯɾɯlmasɯnɯ
uyumlu	ujumlu
uyumuyorlar	ujumujoɾlaɾ
uyup	ujup
uyurken	ujuɾken
uyuyan	ujujan
uyuz	ujuz
uyuşturucu	ujuʃtuɾud͡ʒu
uyuşuyor	ujuʃujoɾ
uzadıkça	uzadɯkt͡ʃa
uzaklaştı	uzaklaʃtɯ
uzakta	uzakta
uzaktan	uzaktan
uzandığınızda	uzandɯɰɯnɯzda
uzansa	uzansa
uzatıp	uzatɯp
uzay	uzaj
uzaya	uzaja
uzağımızda	uzaɰɯmɯzda
üzen	yzen
üzere	yzeɾe
üzeredir	yzeɾediɾ
üzerimde	yzeɾimde
üzerinde	yzeɾinde
üzerindeki	yzeɾindeki
üzerinden	yzeɾinden
üzerine	yzeɾine
üzgün	yzɡyn
üzgündü	yzɡyndy
uzlaşma	uzlaʃma
uzmanları	uzmanlaɾɯ
uzmanlarından	uzmanlaɾɯndan
üzülüyorlar	yzylyjoɾlaɾ
üzülüyorlardı	yzylyjoɾlaɾdɯ
üzümler	yzymleɾ
uzun	uzun
üzüntü	yzynty
uzuyor	uzujoɾ
uğuldayan	uɰuldajan
uğursuz	uɰuɾsuz
vadeli	vadeli
vahlar	vahlaɾ
vahşet	vahʃet
valilik	valilik
vapur	vapuɾ
vapuruna	vapuɾuna
var	vaɾ
vardı	vaɾdɯ
vardır	vaɾdɯɾ
varken	vaɾken
varlıkları	vaɾlɯklaɾɯ
varlıkların	vaɾlɯklaɾɯn
varlığını	vaɾlɯɰɯnɯ
varmak	vaɾmak
varmış	vaɾmɯʃ
varmışçasına	vaɾmɯʃt͡ʃasɯna
varoluş	vaɾoluʃ
varsa	vaɾsa
varsayar	vaɾsajaɾ
vazgeçiş	vazɡet͡ʃiʃ
vazgeçmiyordu	vazɡet͡ʃmijoɾdu
vazgeçmiş	vazɡet͡ʃmiʃ
vb	vb
ve	ve
veda	veda
verdi	veɾdi
verdiniz	veɾdiniz
verdiği	veɾdiɰi
verdiğimiz	veɾdiɰimiz
verebilecek	veɾebiled͡ʒek
verecek	veɾed͡ʒek
verecekler	veɾed͡ʒekleɾ
vereceği	veɾed͡ʒeɰi
vereceğim	veɾed͡ʒeɰim
veremez	veɾemez
veren	veɾen
verenlere	veɾenleɾe
vererek	veɾeɾek
vergi	veɾɡi
veril	veɾil
verildi	veɾildi
verilecek	veɾiled͡ʒek
verileceğini	veɾiled͡ʒeɰini
verilen	veɾilen
verilir	veɾiliɾ
verilmiş	veɾilmiʃ
verilse	veɾilse
verip	veɾip
verir	veɾiɾ
veriyor	veɾijoɾ
veriyordu	veɾijoɾdu
veriyorum	veɾijoɾum
verme	veɾme
vermedim	veɾmedim
vermek	veɾmek
vermektedir	veɾmektediɾ
vermeleri	veɾmeleɾi
vermeye	veɾmeje
vermeyen	veɾmejen
vermiş	veɾmiʃ
vermişti	veɾmiʃti
versiyonları	veɾsijonlaɾɯ
versiyonu	veɾsijonu
vesile	vesile
veya	veja
virüsünün	viɾysynyn
vizyon	vizjon
voltasına	voltasɯna
vücudumun	vyd͡ʒudumun
vücudunun	vyd͡ʒudunun
vücudunuz	vyd͡ʒudunuz
vücut	vyd͡ʒut
vurguladı	vuɾɡuladɯ
vurgulanması	vuɾɡulanmasɯ
vurmaya	vuɾmaja
vuruldu	vuɾuldu
vurulur	vuɾuluɾ
vurup	vuɾup
ya	ja
yabancı	jaband͡ʒɯ
yabancılara	jaband͡ʒɯlaɾa
yabancısı	jaband͡ʒɯsɯ
yad	jad
yada	jada
yadırgamadılar	jadɯɾɡamadɯlaɾ
yahut	jahut
yaka	jaka
yakaladık	jakaladɯk
yakalanmış	jakalanmɯʃ
yakların	jaklaɾɯn
yaklarınkinden	jaklaɾɯnkinden
yaklaştı	jaklaʃtɯ
yaklaşık	jaklaʃɯk
yakılmasıyla	jakɯlmasɯjla
yakın	jakɯn
yakıt	jakɯt
yakışık	jakɯʃɯk
yalan	jalan
yalanını	jalanɯnɯ
yalnız	jalnɯz
yalnızca	jalnɯzd͡ʒa
yalvaran	jalvaɾan
yalıya	jalɯja
yalıyı	jalɯjɯ
yan	jan
yana	jana
yanaklarına	janaklaɾɯna
yanaşmak	janaʃmak
yandan	jandan
yani	jani
yanlış	janlɯʃ
yansıyor	jansɯjoɾ
yansıyordu	jansɯjoɾdu
yanı	janɯ
yanımızda	janɯmɯzda
yanında	janɯnda
yanındakiler	janɯndakileɾ
yanıtlar	janɯtlaɾ
yanıtını	janɯtɯnɯ
yapabildiğimiz	japabildiɰimiz
yapabileceğini	japabiled͡ʒeɰini
yapabilen	japabilen
yapacağım	japad͡ʒaɰɯm
yapacağımı	japad͡ʒaɰɯmɯ
yapacağımız	japad͡ʒaɰɯmɯz
yapacağına	japad͡ʒaɰɯna
yapacağını	japad͡ʒaɰɯnɯ
yapamaz	japamaz
yapan	japan
yapar	japaɾ
yaparak	japaɾak
yaparken	japaɾken
yaparlar	japaɾlaɾ
yaparlardı	japaɾlaɾdɯ
yaparsınız	japaɾsɯnɯz
yapmadınız	japmadɯnɯz
yapmak	japmak
yapması	japmasɯ
yapmaya	japmaja
yapmıyordu	japmɯjoɾdu
yaprakları	japɾaklaɾɯ
yapraklarımızı	japɾaklaɾɯmɯzɯ
yapsa	japsa
yapsam	japsam
yaptı	japtɯ
yaptırdı	japtɯɾdɯ
yaptırdığı	japtɯɾdɯɰɯ
yaptırmak	japtɯɾmak
yaptığı	japtɯɰɯ
yaptığım	japtɯɰɯm
yaptığını	japtɯɰɯnɯ
yapı	japɯ
yapılacak	japɯlad͡ʒak
yapılan	japɯlan
yapılarak	japɯlaɾak
yapıları	japɯlaɾɯ
yapıldı	japɯldɯ
yapıldığı	japɯldɯɰɯ
yapılması	japɯlmasɯ
yapılmış	japɯlmɯʃ
yapılmıştı	japɯlmɯʃtɯ
yapılırsa	japɯlɯɾsa
yapılıyorsa	japɯlɯjoɾsa
yapım	japɯm
yapımı	japɯmɯ
yapın	japɯn
yapısı	japɯsɯ
yapısını	japɯsɯnɯ
yapıyor	japɯjoɾ
yapıyorsunuz	japɯjoɾsunuz
yapışmamış	japɯʃmamɯʃ
yapıştırılıyor	japɯʃtɯɾɯlɯjoɾ
yaralandı	jaɾalandɯ
yaralar	jaɾalaɾ
yaramış	jaɾamɯʃ
yaramıştı	jaɾamɯʃtɯ
yarar	jaɾaɾ
yararlandığımız	jaɾaɾlandɯɰɯmɯz
yararlı	jaɾaɾlɯ
yaratabilecek	jaɾatabiled͡ʒek
yaratmak	jaɾatmak
yaratmaktı	jaɾatmaktɯ
yarattığınız	jaɾattɯɰɯnɯz
yaratıcı	jaɾatɯd͡ʒɯ
yaratılan	jaɾatɯlan
yaratın	jaɾatɯn
yaratıyor	jaɾatɯjoɾ
yaratıyorum	jaɾatɯjoɾum
yardım	jaɾdɯm
yardımcı	jaɾdɯmd͡ʒɯ
yardımcılarına	jaɾdɯmd͡ʒɯlaɾɯna
yardımda	jaɾdɯmda
yarı	jaɾɯ
yarıdan	jaɾɯdan
yarım	jaɾɯm
yarınsız	jaɾɯnsɯz
yarısından	jaɾɯsɯndan
yarısını	jaɾɯsɯnɯ
yarışmalar	jaɾɯʃmalaɾ
yasak	jasak
yasalar	jasalaɾ
yasasının	jasasɯnɯn
yaslanıyor	jaslanɯjoɾ
yat	jat
yataktayım	jataktajɯm
yatağa	jataɰa
yatçılığının	jatt͡ʃɯlɯɰɯnɯn
yatlarda	jatlaɾda
yattılar	jattɯlaɾ
yatıdır	jatɯdɯɾ
yatırımları	jatɯɾɯmlaɾɯ
yatırımlarımızın	jatɯɾɯmlaɾɯmɯzɯn
yatıştırıyordu	jatɯʃtɯɾɯjoɾdu
yavaş	javaʃ
yavaşlattı	javaʃlattɯ
yaya	jaja
yayılıp	jajɯlɯp
yayın	jajɯn
yayınlandı	jajɯnlandɯ
yayınlanmasının	jajɯnlanmasɯnɯn
yayınlanmaya	jajɯnlanmaja
yayınlar	jajɯnlaɾ
yayınlarken	jajɯnlaɾken
yaz	jaz
yazacak	jazad͡ʒak
yazacaktım	jazad͡ʒaktɯm
yazanı	jazanɯ
yazarlarına	jazaɾlaɾɯna
yazarlığıyla	jazaɾlɯɰɯjla
yazdı	jazdɯ
yazgısı	jazɡɯsɯ
yazmak	jazmak
yazmıyorlar	jazmɯjoɾlaɾ
yazıda	jazɯda
yazılmış	jazɯlmɯʃ
yazılı	jazɯlɯ
yazında	jazɯnda
yazınız	jazɯnɯz
yazısında	jazɯsɯnda
yazıya	jazɯja
yağ	jaɰ
yaş	jaʃ
yağa	jaɰa
yaşadık	jaʃadɯk
yaşadıklarımız	jaʃadɯklaɾɯmɯz
yaşam	jaʃam
yaşamak	jaʃamak
yaşamamızı	jaʃamamɯzɯ
yaşamaya	jaʃamaja
yaşamlarını	jaʃamlaɾɯnɯ
yaşamı	jaʃamɯ
yaşamını	jaʃamɯnɯ
yaşanacağını	jaʃanad͡ʒaɰɯnɯ
yaşanmıyor	jaʃanmɯjoɾ
yaşar	jaʃaɾ
yaşarken	jaʃaɾken
yaşayabilir	jaʃajabiliɾ
yaşayabilirim	jaʃajabiliɾim
yaşayan	jaʃajan
yaşlar	jaʃlaɾ
yağlı	jaɰlɯ
yaşlı	jaʃlɯ
yağlıysa	jaɰlɯjsa
yağmur	jaɰmuɾ
yağmurda	jaɰmuɾda
yağsız	jaɰsɯz
yağsızsa	jaɰsɯzsa
yaşı	jaʃɯ
yaşında	jaʃɯnda
yaşındaki	jaʃɯndaki
yaşındaydım	jaʃɯndajdɯm
yaşındaymış	jaʃɯndajmɯʃ
yaşıyor	jaʃɯjoɾ
ydi	jdi
ydiler	jdileɾ
ydü	jdy
ydı	jdɯ
ydık	jdɯk
ydım	jdɯm
ye	je
yedi	jedi
yedide	jedide
yediğimiz	jediɰimiz
yelken	jelken
yelkenli	jelkenli
yelteniyor	jeltenijoɾ
yemek	jemek
yemekler	jemekleɾ
yemekleri	jemekleɾi
yemeklerimizi	jemekleɾimizi
yemekte	jemekte
yememeli	jememeli
yememelidir	jememelidiɾ
yemez	jemez
yemeği	jemeɰi
yemiş	jemiʃ
yemiştik	jemiʃtik
yendikleri	jendikleɾi
yeni	jeni
yeniçeriye	jenit͡ʃeɾije
yeniden	jeniden
yenilenmiş	jenilenmiʃ
yenilikçi	jenilikt͡ʃi
yenilmiş	jenilmiʃ
yenir	jeniɾ
yer	jeɾ
yeraltı	jeɾaltɯ
yerde	jeɾde
yerden	jeɾden
yere	jeɾe
yerel	jeɾel
yeri	jeɾi
yerinde	jeɾinde
yerindeki	jeɾindeki
yerinden	jeɾinden
yerine	jeɾine
yerini	jeɾini
yerlerde	jeɾleɾde
yerleşmesini	jeɾleʃmesini
yerüstü	jeɾysty
yeryüzüne	jeɾjyzyne
yesin	jesin
yetenekleri	jetenekleɾi
yetenekli	jetenekli
yeteneğinin	jeteneɰinin
yeter	jeteɾ
yeterince	jeteɾind͡ʒe
yeterli	jeteɾli
yetindi	jetindi
yetiş	jetiʃ
yetişir	jetiʃiɾ
yetişkinliğe	jetiʃkinliɰe
yetişmiş	jetiʃmiʃ
yetiştirmek	jetiʃtiɾmek
yeşil	jeʃil
yeşile	jeʃile
yine	jine
yitirdiler	jitiɾdileɾ
yitirmiş	jitiɾmiʃ
yitirmişti	jitiɾmiʃti
yitirmiştim	jitiɾmiʃtim
yiyecek	jijed͡ʒek
yiyeceklerle	jijed͡ʒekleɾle
yiyenlerde	jijenleɾde
yiyip	jijip
yken	jken
ymuş	jmuʃ
ymış	jmɯʃ
yok	jok
yoksa	joksa
yoksul	joksul
yoksun	joksun
yoktu	joktu
yokuş	jokuʃ
yokuşu	jokuʃu
yokuşun	jokuʃun
yol	jol
yola	jola
yolculuk	jold͡ʒuluk
yolculuğundan	jold͡ʒuluɰundan
yolculuğunu	jold͡ʒuluɰunu
yolda	jolda
yolladı	jolladɯ
yollar	jollaɾ
yolları	jollaɾɯ
yoluma	joluma
yolun	jolun
yolunda	jolunda
yolundaki	jolundaki
yolunu	jolunu
yönde	jœnde
yönden	jœnden
yönelen	jœnelen
yönelik	jœnelik
yönelmiş	jœnelmiʃ
yönetecek	jœneted͡ʒek
yönetenleri	jœnetenleɾi
yöneticiler	jœnetid͡ʒileɾ
yönetilmesi	jœnetilmesi
yönetim	jœnetim
yönetimi	jœnetimi
yönetiminde	jœnetiminde
yönetimiyse	jœnetimijse
yönetir	jœnetiɾ
yönetmeyi	jœnetmeji
yönettim	jœnettim
yönlendirilmedikleri	jœnlendiɾilmedikleɾi
yönlerden	jœnleɾden
yönlerinden	jœnleɾinden
yöntem	jœntem
yönteme	jœnteme
yöntemi	jœntemi
yönteminin	jœnteminin
yöntemiyle	jœntemijle
yöntemler	jœntemleɾ
yönü	jœny
yönündeki	jœnyndeki
yorgunluk	joɾɡunluk
yorgunluğun	joɾɡunluɰun
yorucu	joɾud͡ʒu
yorulmaya	joɾulmaja
yorumladığı	joɾumladɯɰɯ
yorumu	joɾumu
yosunları	josunlaɾɯ
yoğun	joɰun
ysa	jsa
yse	jse
yüceliğini	jyd͡ʒeliɰini
yük	jyk
yukarı	jukaɾɯ
yüklenmiş	jyklenmiʃ
yüksek	jyksek
yükselen	jykselen
yükseliyor	jykselijoɾ
yükselmenin	jykselmenin
yükselmeye	jykselmeje
yükümlü	jykymly
yumurta	jumuɾta
yumurtalı	jumuɾtalɯ
yünden	jynden
yurdumuzun	juɾdumuzun
yüreğimi	jyɾeɰimi
yurtdışı	juɾtdɯʃɯ
yurttaşların	juɾttaʃlaɾɯn
yürüdü	jyɾydy
yürütülüyor	jyɾytylyjoɾ
yürütülüyordu	jyɾytylyjoɾdu
yürüyüş	jyɾyjyʃ
yürüyüşe	jyɾyjyʃe
yüz	jyz
yüzde	jyzde
yüzden	jyzden
yüzdüğümüz	jyzdyɰymyz
yüzeyinde	jyzejinde
yüzeyindeki	jyzejindeki
yüzlerce	jyzleɾd͡ʒe
yüzü	jyzy
yüzüme	jyzyme
yüzüne	jyzyne
yıkanıp	jɯkanɯp
yıkayın	jɯkajɯn
yıkayınız	jɯkajɯnɯz
yıl	jɯl
yılan	jɯlan
yılda	jɯlda
yıldan	jɯldan
yıldır	jɯldɯɾ
yıllar	jɯllaɾ
yıllardan	jɯllaɾdan
yıllardır	jɯllaɾdɯɾ
yıllık	jɯllɯk
yılı	jɯlɯ
yılında	jɯlɯnda
yılını	jɯlɯnɯ
yılının	jɯlɯnɯn
yım	jɯm
zabiti	zabiti
zafersiz	zafeɾsiz
zaman	zaman
zamana	zamana
zamanda	zamanda
zamanla	zamanla
zamanlar	zamanlaɾ
zamanı	zamanɯ
zamanımızda	zamanɯmɯzda
zamanında	zamanɯnda
zarar	zaɾaɾ
zarf	zaɾf
zaruret	zaɾuɾet
zaten	zaten
zavallı	zavallɯ
zayıf	zajɯf
zayıflamayı	zajɯflamajɯ
zayıflıklarının	zajɯflɯklaɾɯnɯn
zehirlenip	zehiɾlenip
zekâ	zekâ
zekice	zekid͡ʒe
zemin	zemin
zenci	zend͡ʒi
zengin	zenɡin
zenginliklerinin	zenɡinlikleɾinin
zevkli	zevkli
zeytin	zejtin
zihinde	zihinde
zihinsel	zihinsel
zihinselliğini	zihinselliɰini
zirvede	ziɾvede
ziyaret	zijaɾet
ziyaretini	zijaɾetini
zor	zoɾ
zorlanır	zoɾlanɯɾ
zorlu	zoɾlu
zorlukla	zoɾlukla
zorluklarla	zoɾluklaɾla
zorunda	zoɾunda
zorunlu	zoɾunlu
zulmün	zulmyn
ı	ɯ
şahane	ʃahane
şahit	ʃahit
şahsen	ʃahsen
şahsiyet	ʃahsijet
şahsında	ʃahsɯnda
şahıslar	ʃahɯslaɾ
şakalaşabildiğimiz	ʃakalaʃabildiɰimiz
şansı	ʃansɯ
şarkı	ʃaɾkɯ
şarkılara	ʃaɾkɯlaɾa
şarkıları	ʃaɾkɯlaɾɯ
şart	ʃaɾt
şartlara	ʃaɾtlaɾa
şaşırdı	ʃaʃɯɾdɯ
şaşırtıcı	ʃaʃɯɾtɯd͡ʒɯ
şehir	ʃehiɾ
şehrin	ʃehɾin
şeker	ʃekeɾ
şekilde	ʃekilde
şekli	ʃekli
şeklinde	ʃeklinde
şeklindeydi	ʃeklindejdi
şeklinizi	ʃeklinizi
şey	ʃej
şeyden	ʃejden
şeye	ʃeje
şeyi	ʃeji
şeyim	ʃejim
şeyin	ʃejin
şeyler	ʃejleɾ
şiddete	ʃiddete
şiddetinde	ʃiddetinde
şiddetindeki	ʃiddetindeki
şiddetli	ʃiddetli
şiddetliyken	ʃiddetlijken
şiirler	ʃiiɾleɾ
şikayet	ʃikajet
şikayete	ʃikajete
şimdi	ʃimdi
şimdiden	ʃimdiden
şimdiye	ʃimdije
şişede	ʃiʃede
şişen	ʃiʃen
şişlemeleri	ʃiʃlemeleɾi
şişmanlık	ʃiʃmanlɯk
şoförü	ʃofœɾy
şöyle	ʃœjle
ısrarla	ɯsɾaɾla
ıssızlığı	ɯssɯzlɯɰɯ
ısınmayla	ɯsɯnmajla
ısıtmaktan	ɯsɯtmaktan
şu	ʃu
şudur	ʃuduɾ
şunu	ʃunu
şüphe	ʃyphe
şüpheli	ʃypheli
şık	ʃɯk
şıktı	ʃɯktɯ
ışık	ɯʃɯk
ışınları	ɯʃɯnlaɾɯ
ışığında	ɯʃɯɰɯnda
