	
«ئانا»	«ana»
«مېنىڭ	«meniŋ
«يېيىش»كە	«jejiʃ»kɛ
«قورساق	«qorsaq
«يۇقىرى	«juqiri
«بالىلىق	«baliliq
«كىشىلەر	«kiʃilɛr
«شاپپىدە»	«ʃappidɛ»
«مۇقىمسىزلىق»نى	«muqimsizliq»ni
&gt;	&gt;
&lt;	&lt;
(1868-1936)	(1868-1936)
(مايسا)	(majsa)
0	0
1	1
1-	1-
10	10
100	100
1008	1008
1025	1025
11	11
14	14
15	15
150	150
16	16
16-17	16-17
18	18
1840	1840
1848	1848
1928-يىلى	1928-jili
1947	1947
1969-	1969-
2	2
2-	2-
20	20
20-	20-
2000	2000
2010	2010
2012-_يىلى_4-ئاينىڭ_3-كۈنى	2012-_jili_4-ajniŋ_3-kyni
2015	2015
20_يىل	20_jil
21	21
22	22
23	23
24	24
3	3
30	30
300	300
3000	3000
35	35
3500	3500
4	4
40	40
400	400
40تىن	40tin
43	43
5	5
50	50
500	500
55	55
6-	6-
60	60
600	600
6000	6000
65	65
7	7
7-	7-
70	70
90	90
advcl	advcl
−	−
٪70تىن	٪70tin
ئش	eʃ
ئۇ	u
ئۈ	y
بۇ	bu
تا	ta
خو	χo
دە	dɛ
سۇ	su
شا	ʃa
شۇ	ʃu
غا	ʁa
لى	li
مو	mo
نى	ni
نە	nɛ
يا	ja
يۇ	ju
گە	ɡɛ
ھا	ha
ھە	hɛ
ۋۇ	wu
ۋە	wɛ
لۇ_كاڭ	lu_kaŋ
ھە_دەپ	hɛ_dɛp
،بۇ	،bu
ئات	at
ئاز	az
ئاش	aʃ
ئاق	aq
ئال	al
ئاي	aj
ئاچ	at͡ʃ
ئاھ	ah
ئوت	ot
ئون	on
ئوي	oj
ئوڭ	oŋ
ئوۋ	ow
ئىس	is
ئىش	iʃ
ئىچ	it͡ʃ
ئۆز	øz
ئۆي	øj
ئۆچ	øt͡ʃ
ئۇل	ul
ئۈن	yn
ئۈچ	yt͡ʃ
ئەر	ɛr
ئەس	ɛs
ئەل	ɛl
ئەي	ɛj
ئەڭ	ɛŋ
بار	bar
باش	baʃ
باغ	baʁ
باق	baq
باي	baj
بوز	boz
بوش	boʃ
بوم	bom
بوي	boj
بىخ	biχ
بىر	bir
بىز	biz
بۈك	byk
بەر	bɛr
بەس	bɛs
بەش	bɛʃ
بەك	bɛk
تاج	tad͡ʒ
تار	tar
تاس	tas
تاش	taʃ
تاغ	taʁ
تال	tal
تام	tam
تاڭ	taŋ
تور	tor
توق	toq
توك	tok
توم	tom
تون	ton
توي	toj
توپ	top
تىت	tit
تۆت	tøt
تۇر	tur
تۈن	tyn
تۈپ	typ
تېز	tez
تېن	ten
تەس	tɛs
تەق	tɛq
تەن	tɛn
تەپ	tɛp
تەڭ	tɛŋ
جان	d͡ʒan
جاي	d͡ʒaj
جىق	d͡ʒiq
جىم	d͡ʒim
جىن	d͡ʒin
جۆر	d͡ʒør
جۈپ	d͡ʒyp
جەم	d͡ʒɛm
خاس	χas
خام	χam
خوش	χoʃ
خوپ	χop
خىل	χil
خۇش	χuʃ
خېڭ	χeŋ
خەت	χɛt
خەق	χɛq
دار	dar
دان	dan
دوغ	doʁ
دىل	dil
دىن	din
دۆت	døt
دۈم	dym
دەس	dɛs
دەل	dɛl
دەم	dɛm
دەي	dɛj
دەپ	dɛp
دەڭ	dɛŋ
رول	rol
روھ	roh
رەت	rɛt
رەڭ	rɛŋ
زور	zor
زىل	zil
زىچ	zit͡ʃ
زەر	zɛr
زەن	zɛn
ساز	saz
ساق	saq
سان	san
ساپ	sap
سول	sol
سوم	som
سىر	sir
سىز	siz
سۆز	søz
سۇس	sus
سۇن	sun
سۈر	syr
سەت	sɛt
سەل	sɛl
سەن	sɛn
سەپ	sɛp
شاخ	ʃaχ
شاد	ʃad
شار	ʃar
شال	ʃal
شاپ	ʃap
شوخ	ʃoχ
شور	ʃor
شوك	ʃok
شىر	ʃir
غال	ʁal
غەم	ʁɛm
قات	qat
قار	qar
قاش	qaʃ
قاق	qaq
قان	qan
قاپ	qap
قوش	qoʃ
قول	qol
قوي	qoj
قىز	qiz
قىش	qiʃ
قۇر	qur
قۇش	quʃ
قۇم	qum
قەد	qɛd
كان	kan
كىر	kir
كىم	kim
كۆر	kør
كۆز	køz
كۆك	køk
كۆل	køl
كۆپ	køp
كۈز	kyz
كۈن	kyn
كۈچ	kyt͡ʃ
كەت	kɛt
كەس	kɛs
كەل	kɛl
كەم	kɛm
كەچ	kɛt͡ʃ
كەڭ	kɛŋ
لاي	laj
لوم	lom
ماس	mas
مال	mal
ماي	maj
مول	mol
مىس	mis
مىڭ	miŋ
مۇخ	muχ
مۇز	muz
مەن	mɛn
مەي	mɛj
نام	nam
نان	nan
نۆل	nøl
نۇر	nur
نەس	nɛs
نەق	nɛq
ياد	jad
ياز	jaz
ياش	jaʃ
ياق	jaq
يان	jan
يوق	joq
يول	jol
يىل	jil
يىپ	jip
يۇڭ	juŋ
يۈز	jyz
يۈك	jyk
يەت	jɛt
يەر	jɛr
يەل	jɛl
يەي	jɛj
يەپ	jɛp
يەڭ	jɛŋ
پات	pat
پاش	paʃ
پاك	pak
پال	pal
پاي	paj
پاھ	pah
پىخ	piχ
پىل	pil
پۇت	put
پۇل	pul
پۈپ	pyp
پەس	pɛs
پەم	pɛm
پەن	pɛn
پەي	pɛj
چاي	t͡ʃaj
چاچ	t͡ʃat͡ʃ
چوت	t͡ʃot
چوڭ	t͡ʃoŋ
چىش	t͡ʃiʃ
چىن	t͡ʃin
چىپ	t͡ʃip
چىڭ	t͡ʃiŋ
چۆپ	t͡ʃøp
چۈش	t͡ʃyʃ
چەت	t͡ʃɛt
گاز	ɡaz
گۆش	ɡøʃ
گۈل	ɡyl
گەپ	ɡɛp
ھار	har
ھال	hal
ھاي	haj
ھور	hor
ھىم	him
ھۆر	hør
ھۆل	høl
ھۇل	hul
ھېس	hes
ھېچ	het͡ʃ
ھەر	hɛr
ھەق	hɛq
ھەل	hɛl
ھەم	hɛm
ھەي	hɛj
ۋاز	waz
ۋاق	waq
ۋاي	waj
ۋوي	woj
ۋۇي	wuj
–دە	–dɛ
سىز«	siz«
دۆڭ»دىكى	døŋ»diki
بار-ھە	bar-hɛ
تال-تال	tal-tal
توپ-توپ	top-top
قار-مۇز	qar-muz
كۆز-كۆز	køz-køz
مۇڭ-زار	muŋ-zar
پات-پات	pat-pat
ۋاي-ۋۇي	waj-wuj
ئۆز-ئارا	øz-ara
ئەس-يادى	ɛs-jadi
چاڭ-توپا	t͡ʃaŋ-topa
ئەر-ئايال	ɛr-ajal
ئەر-خوتۇن	ɛr-χotun
بىر-نەچچە	bir-nɛt͡ʃt͡ʃɛ
جان-جەھلى	d͡ʒan-d͡ʒɛhli
دەل-دەرەخ	dɛl-dɛrɛχ
شان-شەرەپ	ʃan-ʃɛrɛp
كۆز-قۇلاق	køz-qulaq
چاڭ-توزاڭ	t͡ʃaŋ-tozaŋ
گۈل-گىياھ	ɡyl-ɡijah
ئۆز-ئۆزىگە	øz-øziɡɛ
بىر-بىرلەپ	bir-birlɛp
بىر-بىرىنى	bir-birini
بىر-بىرىگە	bir-biriɡɛ
قول-قانىتى	qol-qaniti
قىن-قىنىغا	qin-qiniʁa
بىر-بىرىنىڭ	bir-biriniŋ
پەن-تېخنىكا	pɛn-teχnika
چۆل-باياۋان	t͡ʃøl-bajawan
ئەر-ئاياللار	ɛr-ajallar
ئەر-ئايالنىڭ	ɛr-ajalniŋ
دەل-دەرەخلەر	dɛl-dɛrɛχlɛr
شاخ-شاخلاردا	ʃaχ-ʃaχlarda
بار-يوقلۇقىنى	bar-joqluqini
قار-مۇزلاردىن	qar-muzlardin
يۈز-كۆزلىرىگە	jyz-køzliriɡɛ
قاش-كۆزلىرىدىن	qaʃ-køzliridin
پەن-تېخنىكىنىڭ	pɛn-teχnikiniŋ
مال-دۇنياسىغىمۇ	mal-dunjasiʁimu
گەپ-سۆزلىرىگىچە	ɡɛp-søzliriɡit͡ʃɛ
فەن_گاڭ	fɛn_ɡaŋ
ياڭ_شىزو	jaŋ_ʃizo
يۈز_بەردى	jyz_bɛrdi
دوڭ_مەنيۈەن	doŋ_mɛnjyɛn
باش_مۇھەررىر	baʃ_muhɛrrir
دۇچ_كېلىدىغان	dut͡ʃ_kelidiʁan
ھېس_قىلغانىدىم	hes_qilʁanidim
كۆز_يۇممىغانلىقتىن	køz_jummiʁanliqtin
،كەل	،kɛl
ئاتا	ata
ئادا	ada
ئاشۇ	aʃu
ئاكا	aka
ئالا	ala
ئانا	ana
ئاپا	apa
ئاۋۇ	awu
ئسمى	esmi
ئشنى	eʃni
ئوقى	oqi
ئوھۇ	ohu
ئىدى	idi
ئىزى	izi
ئىشك	iʃk
ئىشى	iʃi
ئىلى	ili
ئىچى	it͡ʃi
ئىگە	iɡɛ
ئۆتە	øtɛ
ئۆرە	ørɛ
ئۆزى	øzi
ئۇكا	uka
ئۇلى	uli
ئۇمۇ	umu
ئۇنى	uni
ئۇنڭ	unŋ
ئۇۋا	uwa
ئېرى	eri
ئېلى	eli
ئېيت	ejt
ئەتە	ɛtɛ
ئەزا	ɛza
ئەكس	ɛks
ئەلا	ɛla
ئەلى	ɛli
ئەنە	ɛnɛ
ئەپۇ	ɛpu
ئەۋج	ɛwd͡ʒ
بارا	bara
بالا	bala
بايا	baja
باھا	baha
بويى	boji
بوۋا	bowa
بىرى	biri
بىرە	birɛ
بىنا	bina
بۆرە	børɛ
بۇغا	buʁa
بۇغۇ	buʁu
بۇقا	buqa
بۇلا	bula
بۇمۇ	bumu
بۇنى	buni
بېتى	beti
بېرى	beri
بېشى	beʃi
بېلى	beli
بېگى	beɡi
بەزى	bɛzi
بەنت	bɛnt
بەند	bɛnd
تازا	taza
تاغا	taʁa
تاكى	taki
تانا	tana
تاۋى	tawi
توخو	toχo
توخۇ	toχu
تورى	tori
توكى	toki
تولا	tola
توپا	topa
توپى	topi
توڭى	toŋi
تىلى	tili
تىنچ	tint͡ʃ
تىپى	tipi
تۆشى	tøʃi
تۆگە	tøɡɛ
تۇجى	tud͡ʒi
تېخى	teχi
تېرە	terɛ
تېشى	teʃi
تېغى	teʁi
تېگى	teɡi
تەسس	tɛss
جادۇ	d͡ʒadu
جاپا	d͡ʒapa
جىمى	d͡ʒimi
جۆرە	d͡ʒørɛ
جۇمۇ	d͡ʒumu
جېنى	d͡ʒeni
جەلپ	d͡ʒɛlp
خاتا	χata
خاپا	χapa
خڭجۇ	χŋd͡ʒu
خۇدا	χuda
خېلى	χeli
خەلق	χɛlq
خەۋپ	χɛwp
دادا	dada
دانە	danɛ
دورا	dora
دوست	dost
دوغى	doʁi
دىدى	didi
دىلى	dili
دۆۋە	døwɛ
دېدى	dedi
دەرس	dɛrs
دەست	dɛst
دەۋر	dɛwr
رازى	razi
راست	rast
راۋا	rawa
رۇەن	ruɛn
رەخت	rɛχt
زادى	zadi
زايا	zaja
سادا	sada
ساشا	saʃa
سانى	sani
ساڭا	saŋa
سكوت	skot
سودا	soda
سىرت	sirt
سىلى	sili
سىمى	simi
سىنى	sini
سۆزى	søzi
سۇدا	suda
سۇغا	suʁa
سۇنى	suni
سۈيى	syji
سېنى	seni
سەرپ	sɛrp
سەۋر	sɛwr
شارى	ʃari
شايى	ʃaji
شىخو	ʃiχo
شىرە	ʃirɛ
شۇنى	ʃuni
شۇنڭ	ʃunŋ
شۇڭا	ʃuŋa
شەرت	ʃɛrt
شەرق	ʃɛrq
غولى	ʁoli
غەرب	ʁɛrb
غەرق	ʁɛrq
فوتو	foto
قارا	qara
قوزا	qoza
قولى	qoli
قىزى	qizi
قىلش	qilʃ
قىيا	qija
قۇرت	qurt
قۇشى	quʃi
قېتى	qeti
قېرى	qeri
قېنى	qeni
كالا	kala
كاۋا	kawa
كراي	kraj
كونا	kona
كوچا	kot͡ʃa
كىرا	kira
كىشى	kiʃi
كىلە	kilɛ
كۆرە	kørɛ
كۆزى	køzi
كۈنى	kyni
كۈچى	kyt͡ʃi
كېتپ	ketp
كېلە	kelɛ
كېمە	kemɛ
كېنى	keni
كېچە	ket͡ʃɛ
كەنت	kɛnt
لاتا	lata
مانا	mana
ماڭا	maŋa
ماۋۇ	mawu
مودا	moda
مىنى	mini
مىۋە	miwɛ
مۇشۇ	muʃu
مۇنۇ	munu
مېنى	meni
مېڭە	meŋɛ
مېۋە	mewɛ
نالە	nalɛ
نامى	nami
نىمە	nimɛ
نۇرى	nuri
نېرى	neri
نېمە	nemɛ
نەگە	nɛɡɛ
ياقا	jaqa
ياكى	jaki
ياۋا	jawa
يولى	joli
يىغا	jiʁa
يىلى	jili
يىڭى	jiŋi
يۇدى	judi
يۇرت	jurt
يۇقا	juqa
يۈزى	jyzi
يۈەن	jyɛn
يېدى	jedi
يېرى	jeri
يېزا	jeza
يېشى	jeʃi
يېڭى	jeŋi
يەنى	jɛni
يەنە	jɛnɛ
پولۇ	polu
پىسا	pisa
پىلە	pilɛ
پۇتى	puti
پۇلى	puli
پېتى	peti
پېشى	peʃi
پەرق	pɛrq
پەيت	pɛjt
چارە	t͡ʃarɛ
چاقى	t͡ʃaqi
چالا	t͡ʃala
چوڭى	t͡ʃoŋi
چىشى	t͡ʃiʃi
چىنە	t͡ʃinɛ
چۇفۇ	t͡ʃufu
چېغى	t͡ʃeʁi
چېكى	t͡ʃeki
چېيى	t͡ʃeji
گاھى	ɡahi
گويا	ɡoja
گۆشى	ɡøʃi
گېپى	ɡepi
ھازا	haza
ھالى	hali
ھاۋا	hawa
ھىدى	hidi
ھۆپۈ	høpy
ھېيت	hejt
ھەئە	hɛɛ
ھەدە	hɛdɛ
ھەرە	hɛrɛ
ۋاپا	wapa
ۋەدە	wɛdɛ
ۋەقە	wɛqɛ
دەۋر»	dɛwr»
يولى»غا	joli»ʁa
يېزا--كەنىتتىكى	jeza--kɛnittiki
ئاتا-ئانا	ata-ana
بارا-بارا	bara-bara
مېۋە-چېۋە	mewɛ-t͡ʃewɛ
نېرى-بېرى	neri-beri
ئاتا-ئانام	ata-anam
بوسو-خانتو	boso-χanto
توپا-توزان	topa-tozan
تىنچ-ئامان	tint͡ʃ-aman
سودا-سېتىق	soda-setiq
ئاتا-ئانىسى	ata-anisi
كېچە-كۈندۈز	ket͡ʃɛ-kyndyz
ئاتا-ئانىلىق	ata-aniliq
ئاتا-ئانىمىز	ata-animiz
ئىچى-سىرتىدا	it͡ʃi-sirtida
توپا-توزانغا	topa-tozanʁa
تەقى-تۇرقىنى	tɛqi-turqini
ئۆتە-ئۆتمەيلا	øtɛ-øtmɛjla
قۇرت-قوڭغۇزلار	qurt-qoŋʁuzlar
مېۋە-چېۋىلەرنىڭ	mewɛ-t͡ʃewilɛrniŋ
توپا-توزانلارنىڭ	topa-tozanlarniŋ
باھا_بېرىش_ئورگىنىغا	baha_beriʃ_orɡiniʁa
ئائىت	ait
ئاتاي	ataj
ئاتنى	atni
ئاجىز	ad͡ʒiz
ئاخىر	aχir
ئاداش	adaʃ
ئاددى	addi
ئادەت	adɛt
ئادەم	adɛm
ئارام	aram
ئاران	aran
ئارزۇ	arzu
ئارقا	arqa
ئاساس	asas
ئاسان	asan
ئاستا	asta
ئاستى	asti
ئاسما	asma
ئاشنى	aʃni
ئاغزى	aʁzi
ئاكام	akam
ئالاي	alaj
ئالتە	altɛ
ئالدى	aldi
ئالسا	alsa
ئالما	alma
ئالىم	alim
ئالىي	alij
ئالەم	alɛm
ئامال	amal
ئامان	aman
ئامەت	amɛt
ئانام	anam
ئاندا	anda
ئانرك	anrk
ئانچە	ant͡ʃɛ
ئاياغ	ajaʁ
ئاياق	ajaq
ئايال	ajal
ئايغا	ajʁa
ئاپام	apam
ئاپلا	apla
ئاپەت	apɛt
ئاچاش	at͡ʃaʃ
ئاچتى	at͡ʃti
ئاچما	at͡ʃma
ئاۋاز	awaz
ئاۋام	awam
ئشەنچ	eʃɛnt͡ʃ
ئنسان	ensan
ئوتۇن	otun
ئوخاش	oχaʃ
ئوراپ	orap
ئورنى	orni
ئورۇق	oruq
ئورۇن	orun
ئورەك	orɛk
ئوزاق	ozaq
ئوسال	osal
ئوغلى	oʁli
ئوغۇل	oʁul
ئوقيا	oqja
ئوقۇش	oquʃ
ئوقۇپ	oqup
ئوقۇڭ	oquŋ
ئوقەت	oqɛt
ئوماق	omaq
ئويۇن	ojun
ئويۇپ	ojup
ئوچۇق	ot͡ʃuq
ئوڭاي	oŋaj
ئوۋچى	owt͡ʃi
ئىجاد	id͡ʒad
ئىجىل	id͡ʒil
ئىدىم	idim
ئىدىڭ	idiŋ
ئىدۇق	iduq
ئىسمى	ismi
ئىسىم	isim
ئىشتۇ	iʃtu
ئىشقا	iʃqa
ئىشقۇ	iʃqu
ئىشنى	iʃni
ئىشىك	iʃik
ئىشىم	iʃim
ئىشىڭ	iʃiŋ
ئىككى	ikki
ئىكەن	ikɛn
ئىلغا	ilʁa
ئىلىك	ilik
ئىلىم	ilim
ئىلىپ	ilip
ئىناق	inaq
ئىيۇل	ijul
ئىچكى	it͡ʃki
ئىچىم	it͡ʃim
ئىچىپ	it͡ʃip
ئۆتتى	øtti
ئۆتۈش	øtyʃ
ئۆتۈپ	øtyp
ئۆرۈك	øryk
ئۆرۈپ	øryp
ئۆزۈم	øzym
ئۆزۈڭ	øzyŋ
ئۆسۈش	øsyʃ
ئۆسۈپ	øsyp
ئۆكۈز	økyz
ئۆلكە	ølkɛ
ئۆلۈش	ølyʃ
ئۆلۈم	ølym
ئۆلۈپ	ølyp
ئۆمۈر	ømyr
ئۆيدە	øjdɛ
ئۆينى	øjni
ئۆيگە	øjɡɛ
ئۆيۈم	øjym
ئۆچۈپ	øt͡ʃyp
ئۆڭۈپ	øŋyp
ئۇدۇل	udul
ئۇدۇم	udum
ئۇرسا	ursa
ئۇرۇش	uruʃ
ئۇرۇق	uruq
ئۇرۇپ	urup
ئۇزاق	uzaq
ئۇزۇن	uzun
ئۇستا	usta
ئۇسۇل	usul
ئۇسۇپ	usup
ئۇقتى	uqti
ئۇقۇپ	uqup
ئۇكام	ukam
ئۇكاڭ	ukaŋ
ئۇلار	ular
ئۇلۇغ	uluʁ
ئۇنىڭ	uniŋ
ئۇياق	ujaq
ئۇيان	ujan
ئۇيقۇ	ujqu
ئۇپۇق	upuq
ئۇچار	ut͡ʃar
ئۇچۇر	ut͡ʃur
ئۇچۇپ	ut͡ʃup
ئۇۋال	uwal
ئۈجمە	yd͡ʒmɛ
ئۈزۈش	yzyʃ
ئۈزۈم	yzym
ئۈزۈپ	yzyp
ئۈستى	ysti
ئۈلار	ylar
ئۈمىد	ymid
ئۈنىڭ	yniŋ
ئۈنچە	ynt͡ʃɛ
ئۈنۈم	ynym
ئۈنۈپ	ynyp
ئۈچۈن	yt͡ʃyn
ئېتىش	etiʃ
ئېتىپ	etip
ئېرىق	eriq
ئېرىم	erim
ئېرىپ	erip
ئېرەن	erɛn
ئېسىل	esil
ئېسىم	esim
ئېسىپ	esip
ئېسەن	esɛn
ئېشىپ	eʃip
ئېغىر	eʁir
ئېغىز	eʁiz
ئېغىل	eʁil
ئېقىن	eqin
ئېقىپ	eqip
ئېلان	elan
ئېلىش	eliʃ
ئېلىپ	elip
ئېلىڭ	eliŋ
ئېنىق	eniq
ئېيىق	ejiq
ئېچىش	et͡ʃiʃ
ئېچىپ	et͡ʃip
ئېگىز	eɡiz
ئەتەي	ɛtɛj
ئەجىر	ɛd͡ʒir
ئەجەب	ɛd͡ʒɛb
ئەجەپ	ɛd͡ʒɛp
ئەرزە	ɛrzɛ
ئەزىز	ɛziz
ئەزەم	ɛzɛm
ئەسكى	ɛski
ئەسلا	ɛsla
ئەسلى	ɛsli
ئەسىر	ɛsir
ئەسەر	ɛsɛr
ئەقلى	ɛqli
ئەقىل	ɛqil
ئەكىس	ɛkis
ئەمدى	ɛmdi
ئەمسە	ɛmsɛ
ئەمما	ɛmma
ئەمەس	ɛmɛs
ئەينى	ɛjni
ئەگىپ	ɛɡip
ئەگەر	ɛɡɛr
ئەھلى	ɛhli
باتۇر	batur
بادام	badam
باراي	baraj
باراڭ	baraŋ
باردى	bardi
باردۇ	bardu
بارسا	barsa
باركى	barki
بارمۇ	barmu
باشتا	baʃta
باشقا	baʃqa
باغرى	baʁri
باغقا	baʁqa
باقاي	baqaj
بالام	balam
بايقى	bajqi
باڭگو	baŋɡo
باھار	bahar
بوران	boran
بوشاپ	boʃap
بوغما	boʁma
بوغۇپ	boʁup
بولدى	boldi
بولسا	bolsa
بولكا	bolka
بولۇش	boluʃ
بولۇق	boluq
بولۇپ	bolup
بولۇڭ	boluŋ
بوياپ	bojap
بوپتۇ	boptu
بوۋام	bowam
بوۋاي	bowaj
بوۋاڭ	bowaŋ
بىتتى	bitti
بىخىل	biχil
بىراق	biraq
بىرلا	birla
بىرنى	birni
بىرىپ	birip
بىرگە	birɡɛ
بىرەر	birɛr
بىزدە	bizdɛ
بىزمۇ	bizmu
بىزنى	bizni
بىزنڭ	biznŋ
بىزگە	bizɡɛ
بىكار	bikar
بىلدى	bildi
بىللە	billɛ
بىلىم	bilim
بىلىپ	bilip
بىلەن	bilɛn
بۆسۈش	bøsyʃ
بۆلدى	bøldi
بۆلۈپ	bølyp
بۆلەك	bølɛk
بۇرنى	burni
بۇرۇت	burut
بۇرۇن	burun
بۇلار	bular
بۇلاق	bulaq
بۇلۇت	bulut
بۇنىڭ	buniŋ
بۇنچە	bunt͡ʃɛ
بۇيان	bujan
بۈدۈر	bydyr
بۈيۈك	byjyk
بۈگۈن	byɡyn
بېتتى	betti
بېرىش	beriʃ
بېرىپ	berip
بېرىڭ	beriŋ
بېرەي	berɛj
بېزەپ	bezɛp
بېسىش	besiʃ
بېغىر	beʁir
بېقىش	beqiʃ
بېقىپ	beqip
بېقىڭ	beqiŋ
بېلىق	beliq
بەتنى	bɛtni
بەدەل	bɛdɛl
بەردى	bɛrdi
بەرسە	bɛrsɛ
بەرپا	bɛrpa
بەرگى	bɛrɡi
بەستە	bɛstɛ
بەكلا	bɛkla
بەكلە	bɛklɛ
بەكمۇ	bɛkmu
بەلكى	bɛlki
بەلەن	bɛlɛn
بەھرە	bɛhrɛ
تارام	taram
تاراپ	tarap
تارىم	tarim
تاشقا	taʃqa
تاشقى	taʃqi
تاشمۇ	taʃmu
تاشنى	taʃni
تاغام	taʁam
تاغدا	taʁda
تاغقا	taʁqa
تاغنى	taʁni
تاقىر	taqir
تاقەت	taqɛt
تالاش	talaʃ
تالاي	talaj
تالمۇ	talmu
تاماق	tamaq
تامچە	tamt͡ʃɛ
تانكا	tanka
تاپتا	tapta
تاپتى	tapti
توردا	torda
تورغا	torʁa
تورۇق	toruq
توزۇپ	tozup
توسۇپ	tosup
توشۇش	toʃuʃ
توشۇپ	toʃup
توغرا	toʁra
توقۇش	toquʃ
توقۇپ	toqup
توكقا	tokqa
تولسا	tolsa
تولۇق	toluq
تولۇپ	tolup
تومۇز	tomuz
توننا	tonna
تونۇش	tonuʃ
تونۇپ	tonup
تىرىك	tirik
تىزىق	tiziq
تىزىپ	tizip
تىقىپ	tiqip
تىكىپ	tikip
تىلغا	tilʁa
تىلما	tilma
تىلنى	tilni
تىندى	tindi
تىنىق	tiniq
تىنىچ	tinit͡ʃ
تىيىن	tijin
تۆرەپ	tørɛp
تۆمۈر	tømyr
تۆھپە	tøhpɛ
تۆۋەن	tøwɛn
تۇتاش	tutaʃ
تۇتتى	tutti
تۇتۇش	tutuʃ
تۇتۇپ	tutup
تۇردى	turdi
تۇرسا	tursa
تۇرقى	turqi
تۇرۇش	turuʃ
تۇرۇپ	turup
تۇغما	tuʁma
تۇنجى	tund͡ʒi
تۈتۈن	tytyn
تۈردە	tyrdɛ
تۈزۈش	tyzyʃ
تۈسكە	tyskɛ
تۈلكە	tylkɛ
تۈمەن	tymɛn
تۈگۈل	tyɡyl
تۈگەپ	tyɡɛp
تېتىپ	tetip
تېرىق	teriq
تېرىپ	terip
تېرەك	terɛk
تېزلا	tezla
تېشىش	teʃiʃ
تېشىپ	teʃip
تېمەن	temɛn
تېپىش	tepiʃ
تېپىپ	tepip
تېگىپ	teɡip
تەتىل	tɛtil
تەخسە	tɛχsɛ
تەرگە	tɛrɡɛ
تەرەپ	tɛrɛp
تەزىم	tɛzim
تەستە	tɛstɛ
تەسىر	tɛsir
تەشمە	tɛʃmɛ
تەشنا	tɛʃna
تەكتى	tɛkti
تەكشى	tɛkʃi
تەلىم	tɛlim
تەلەپ	tɛlɛp
تەنھا	tɛnha
تەپتى	tɛpti
تەڭلا	tɛŋla
جانغا	d͡ʒanʁa
جايدا	d͡ʒajda
جايغا	d͡ʒajʁa
جاھان	d͡ʒahan
جاۋاب	d͡ʒawab
جاۋاپ	d͡ʒawap
جىجاپ	d͡ʒid͡ʒap
جىسىم	d͡ʒisim
جىملا	d͡ʒimla
جىمىپ	d͡ʒimip
جۇخار	d͡ʒuχar
جۇڭنى	d͡ʒuŋni
جۇڭگو	d͡ʒuŋɡo
جۇڭگۇ	d͡ʒuŋɡu
جۈملە	d͡ʒymlɛ
جېدەل	d͡ʒedɛl
جېنىم	d͡ʒenim
جەنۇپ	d͡ʒɛnup
خاراب	χarab
خازان	χazan
خالاس	χalas
خالىس	χalis
خالىي	χalij
خانىم	χanim
خلېۋا	χlewa
خوتەن	χotɛn
خورام	χoram
خوشال	χoʃal
خىجىل	χid͡ʒil
خىلدا	χilda
خىلغا	χilʁa
خىلمۇ	χilmu
خىيال	χijal
خۇتۇن	χutun
خۇددى	χuddi
خۇرام	χuram
خۇرۇم	χurum
خۇشال	χuʃal
خۇنەن	χunɛn
خۇيمۇ	χujmu
خۈشال	χyʃal
خەتنى	χɛtni
خەتەر	χɛtɛr
خەققە	χɛqqɛ
خەلقى	χɛlqi
خەۋەر	χɛwɛr
دائىر	dair
دائىم	daim
داجىپ	dad͡ʒip
دادام	dadam
داستا	dasta
دالدا	dalda
داۋام	dawam
دوزاخ	dozaχ
دوغچى	doʁt͡ʃi
دولان	dolan
دوپپا	doppa
دىسكو	disko
دىگەن	diɡɛn
دۆلەت	dølɛt
دۇرۇس	durus
دۇنيا	dunja
دېدىم	dedim
دېرەك	derɛk
دېسەم	desɛm
دېمەك	demɛk
دېمەي	demɛj
دېيىش	dejiʃ
دېڭىز	deŋiz
دېگنە	deɡnɛ
دېگەن	deɡɛn
دەررۇ	dɛrru
دەرىس	dɛris
دەريا	dɛrja
دەرەخ	dɛrɛχ
دەستە	dɛstɛ
دەيدۇ	dɛjdu
دەيلى	dɛjli
دەپتۇ	dɛptu
دەپلا	dɛpla
دەپمۇ	dɛpmu
دەپنە	dɛpnɛ
راسىت	rasit
رايىم	rajim
راھەت	rahɛt
روشەن	roʃɛn
روھقا	rohqa
روھىي	rohij
رىتىم	ritim
رەستە	rɛstɛ
رەسۋا	rɛswa
رەڭدە	rɛŋdɛ
رەڭنى	rɛŋni
رەڭگى	rɛŋɡi
رەڭگە	rɛŋɡɛ
رەھىم	rɛhim
زاكاز	zakaz
زامان	zaman
زىلۋا	zilwa
زىھنى	zihni
زۆرۈر	zøryr
زۇۋان	zuwan
زېرەك	zerɛk
زېھنى	zehni
زەپەر	zɛpɛr
سائەت	saɛt
سابىق	sabiq
ساتاي	sataj
ساختا	saχta
ساددا	sadda
سادىر	sadir
سادىق	sadiq
ساراڭ	saraŋ
ساقچى	saqt͡ʃi
سالام	salam
سالاي	salaj
سالدى	saldi
سالسا	salsa
سامان	saman
ساناش	sanaʃ
ساناپ	sanap
ساناڭ	sanaŋ
ساندا	sanda
ساپاق	sapaq
ساپال	sapal
ساپان	sapan
ساپتۇ	saptu
ساپمۇ	sapmu
ساۋاق	sawaq
سوئال	soal
سوراپ	sorap
سورۇن	sorun
سوزۇپ	sozup
سوغۇق	soʁuq
سوقما	soqma
سوقۇپ	soqup
سولۇپ	solup
سويۇپ	sojup
سوۋغا	sowʁa
سوۋېت	sowet
سىرنى	sirni
سىزمۇ	sizmu
سىزنى	sizni
سىزىپ	sizip
سىزگە	sizɡɛ
سىلاپ	silap
سىلىق	siliq
سىلەر	silɛr
سىناق	sinaq
سىناپ	sinap
سىنىپ	sinip
سىياھ	sijah
سىيەك	sijɛk
سىڭىپ	siŋip
سۆرەپ	sørɛp
سۆزدە	søzdɛ
سۆزنى	søzni
سۆزگە	søzɡɛ
سۆزۈڭ	søzyŋ
سۆسۈن	søsyn
سۆيۈپ	søjyp
سۆگەت	søɡɛt
سۇدىن	sudin
سۇسىز	susiz
سۇلار	sular
سۇنىڭ	suniŋ
سۇنۇپ	sunup
سۈرۈپ	syryp
سۈرەت	syrɛt
سۈزۈك	syzyk
سۈكۈت	sykyt
سۈپەت	sypɛt
سېتىش	setiʃ
سېتىپ	setip
سېرىق	seriq
سېسىق	sesiq
سېغىز	seʁiz
سېلىش	seliʃ
سېلىپ	selip
سېمىز	semiz
سېنىڭ	seniŋ
سەبىي	sɛbij
سەنمۇ	sɛnmu
سەيلە	sɛjlɛ
سەپەر	sɛpɛr
سەھرا	sɛhra
سەھەر	sɛhɛr
سەۋەب	sɛwɛb
سەۋەپ	sɛwɛp
شاختا	ʃaχta
شاخقا	ʃaχqa
شارغا	ʃarʁa
شامال	ʃamal
شامنى	ʃamni
شىزاڭ	ʃizaŋ
شىمال	ʃimal
شۇئان	ʃuan
شۇلار	ʃular
شۇنىڭ	ʃuniŋ
شۇنچە	ʃunt͡ʃɛ
شېئىر	ʃeir
شېرىن	ʃerin
شەكلى	ʃɛkli
شەكىل	ʃɛkil
شەنبە	ʃɛnbɛ
شەيدا	ʃɛjda
شەھەر	ʃɛhɛr
غايىپ	ʁajip
غايەت	ʁajɛt
غوزەك	ʁozɛk
غۇلاپ	ʁulap
غۇلجا	ʁuld͡ʒa
غېرىچ	ʁerit͡ʃ
غەزەپ	ʁɛzɛp
غەلبە	ʁɛlbɛ
فىلىم	filim
قابىل	qabil
قاتار	qatar
قاداق	qadaq
قارار	qarar
قاراش	qaraʃ
قاراپ	qarap
قاراڭ	qaraŋ
قارشى	qarʃi
قارنى	qarni
قاساپ	qasap
قاقاس	qaqas
قالار	qalar
قالاي	qalaj
قالدم	qaldm
قالدى	qaldi
قالسا	qalsa
قانات	qanat
قانچە	qant͡ʃɛ
قايتا	qajta
قايسى	qajsi
قايغۇ	qajʁu
قايىل	qajil
قايچا	qajt͡ʃa
قاپتۇ	qaptu
قاپقا	qapqa
قاۋۇل	qawul
قوبۇل	qobul
قورۇق	qoruq
قوزام	qozam
قوشتى	qoʃti
قوشنا	qoʃna
قولغا	qolʁa
قومۇش	qomuʃ
قوناق	qonaq
قوياش	qojaʃ
قوياي	qojaj
قويدى	qojdi
قويسا	qojsa
قويچى	qojt͡ʃi
قويۇق	qojuq
قويۇپ	qojup
قوپال	qopal
قوڭۇر	qoŋur
قىتىم	qitim
قىرىق	qiriq
قىرىم	qirim
قىرىپ	qirip
قىزغا	qizʁa
قىزنى	qizni
قىزىق	qiziq
قىزىل	qizil
قىزىم	qizim
قىسقا	qisqa
قىسمى	qismi
قىسىم	qisim
قىسىپ	qisip
قىشتا	qiʃta
قىشمۇ	qiʃmu
قىقاس	qiqas
قىقىپ	qiqip
قىلاي	qilaj
قىلدى	qildi
قىلسا	qilsa
قىلما	qilma
قىلىش	qiliʃ
قىلىق	qiliq
قىلىپ	qilip
قىلچە	qilt͡ʃɛ
قىياس	qijas
قىيىن	qijin
قىپتۇ	qiptu
قىچىپ	qit͡ʃip
قۇدۇق	quduq
قۇرتى	qurti
قۇرۇق	quruq
قۇرۇپ	qurup
قۇسۇپ	qusup
قۇشۇم	quʃum
قۇلاق	qulaq
قۇلقى	qulqi
قۇماي	qumaj
قۇمغا	qumʁa
قۇياش	qujaʃ
قۇيۇپ	qujup
قۇچۇپ	qut͡ʃup
قېتىق	qetiq
قېتىم	qetim
قېتىپ	qetip
قېزىپ	qezip
قېقىپ	qeqip
قېلىش	qeliʃ
قېلىن	qelin
قېلىپ	qelip
قېيىت	qejit
قېيىن	qejin
قېيىپ	qejip
قېچىپ	qet͡ʃip
قەدەر	qɛdɛr
قەدەم	qɛdɛm
قەغەز	qɛʁɛz
قەلەم	qɛlɛm
قەلەي	qɛlɛj
قەۋەت	qɛwɛt
كاتتا	katta
كاتىپ	katip
كاتېر	kater
كارىز	kariz
كاللا	kalla
كامار	kamar
كانۋا	kanwa
كولاش	kolaʃ
كىتاب	kitab
كىتىپ	kitip
كىردى	kirdi
كىرسە	kirsɛ
كىرىم	kirim
كىرىپ	kirip
كىرىڭ	kiriŋ
كىرپە	kirpɛ
كىرەك	kirɛk
كىمنى	kimni
كىيدى	kijdi
كىيىش	kijiʃ
كىيىم	kijim
كىيىن	kijin
كىيىپ	kijip
كىچىك	kit͡ʃik
كۆردى	kørdi
كۆرۈش	køryʃ
كۆرۈپ	køryp
كۆرۈڭ	køryŋ
كۆرەڭ	kørɛŋ
كۆزنى	køzni
كۆزۈم	køzym
كۆزۈڭ	køzyŋ
كۆكتە	køktɛ
كۆكسى	køksi
كۆككە	køkkɛ
كۆلنى	kølni
كۆلگە	kølɡɛ
كۆمۈر	kømyr
كۆمۈش	kømyʃ
كۆمۈپ	kømyp
كۆپۈك	køpyk
كۆچۈش	køt͡ʃyʃ
كۆچۈپ	køt͡ʃyp
كۆچەت	køt͡ʃɛt
كۆڭلى	køŋli
كۆڭۈل	køŋyl
كۇرسى	kursi
كۇڭزى	kuŋzi
كۈتتى	kytti
كۈتۇپ	kytup
كۈتۈپ	kytyp
كۈتەي	kytɛj
كۈرەش	kyrɛʃ
كۈزگە	kyzɡɛ
كۈلكە	kylkɛ
كۈلۈپ	kylyp
كۈمۈش	kymyʃ
كۈندە	kyndɛ
كۈنكى	kynki
كۈنىڭ	kyniŋ
كۈنچە	kynt͡ʃɛ
كۈنگە	kynɡɛ
كۈچۈك	kyt͡ʃyk
كۈچەپ	kyt͡ʃɛp
كېتىش	ketiʃ
كېتىپ	ketip
كېتەي	ketɛj
كېرىپ	kerip
كېرەك	kerɛk
كېزىپ	kezip
كېسىش	kesiʃ
كېسىپ	kesip
كېسەل	kesɛl
كېلىش	keliʃ
كېلىپ	kelip
كېلەر	kelɛr
كېلەي	kelɛj
كېيىن	kejin
كېچىش	ket͡ʃiʃ
كېچەك	ket͡ʃɛk
كەتتى	kɛtti
كەتسە	kɛtsɛ
كەتمە	kɛtmɛ
كەررە	kɛrrɛ
كەسىپ	kɛsip
كەسپى	kɛspi
كەلدى	kɛldi
كەلسە	kɛlsɛ
كەينى	kɛjni
كەپتۇ	kɛptu
كەپكە	kɛpkɛ
كەپلا	kɛpla
كەچتە	kɛt͡ʃtɛ
كەچۈر	kɛt͡ʃyr
لازىم	lazim
لامپا	lampa
لايدا	lajda
لايغا	lajʁa
لاينى	lajni
لايىق	lajiq
لاۋزى	lawzi
لىكىن	likin
لېتكى	letki
لېكىن	lekin
لېنىن	lenin
لەرنى	lɛrni
لەشنى	lɛʃni
لەنەت	lɛnɛt
ماتور	mator
ماتۇر	matur
ماشنا	maʃna
ماقال	maqal
ماقۇل	maqul
ماكان	makan
مايسا	majsa
ماڭدى	maŋdi
ماڭسا	maŋsa
ماھىر	mahir
مونچا	mont͡ʃa
مىجەز	mid͡ʒɛz
مىراس	miras
مىرزا	mirza
مىلەپ	milɛp
مىنۇت	minut
مۇجكا	mud͡ʒka
مۇزنى	muzni
مۇزېي	muzej
مۇقىم	muqim
مۇنچە	munt͡ʃɛ
مۇھىت	muhit
مۇھىم	muhim
مۈشۈك	myʃyk
مېتىر	metir
مېدال	medal
مېنىڭ	meniŋ
مېيىپ	mejip
مېڭىش	meŋiʃ
مېڭىپ	meŋip
مېھرى	mehri
مېھىر	mehir
مەدەت	mɛdɛt
مەززە	mɛzzɛ
مەشىق	mɛʃiq
مەلۇم	mɛlum
مەندە	mɛndɛ
مەنزە	mɛnzɛ
مەنمۇ	mɛnmu
مەيلى	mɛjli
مەيىن	mɛjin
مەڭگۈ	mɛŋɡy
ناخشا	naχʃa
نازۇك	nazuk
ناشتا	naʃta
نامنى	namni
ناننى	nanni
نوبىل	nobil
نوپۇس	nopus
نۆۋەت	nøwɛt
نۇرۇڭ	nuruŋ
نەدىن	nɛdin
نەرسە	nɛrsɛ
نەزەر	nɛzɛr
نەقىل	nɛqil
نەيچە	nɛjt͡ʃɛ
نەپكە	nɛpkɛ
نەپىس	nɛpis
نەپەر	nɛpɛr
نەپەس	nɛpɛs
نەچچە	nɛt͡ʃt͡ʃɛ
نەۋرە	nɛwrɛ
ياتتى	jatti
ياتسا	jatsa
ياخشى	jaχʃi
يادقا	jadqa
ياراپ	jarap
يارتا	jarta
يازدى	jazdi
يازما	jazma
ياساش	jasaʃ
ياساپ	jasap
ياشاش	jaʃaʃ
ياشتا	jaʃta
ياشقا	jaʃqa
ياغاچ	jaʁat͡ʃ
يالاڭ	jalaŋ
ياماق	jamaq
يامان	jaman
ياماپ	jamap
يانار	janar
ياندى	jandi
يانغا	janʁa
يانچە	jant͡ʃɛ
ياپتى	japti
ياپون	japon
يوغان	joʁan
يوقاپ	joqap
يوققۇ	joqqu
يوقمۇ	joqmu
يولدا	jolda
يولغا	jolʁa
يولنى	jolni
يوپكا	jopka
يىراق	jiraq
يىغىم	jiʁim
يىغىن	jiʁin
يىغىپ	jiʁip
يىقىن	jiqin
يىلان	jilan
يىلدا	jilda
يىپەك	jipɛk
يىڭنە	jiŋnɛ
يىگىت	jiɡit
يۆلەپ	jølɛp
يۇتۇم	jutum
يۇدۇق	juduq
يۇرتى	jurti
يۇرۇق	juruq
يۇرۇپ	jurup
يۇرەك	jurɛk
يۇلۇپ	julup
يۇمۇپ	jumup
يۇيۇپ	jujup
يۈدۈپ	jydyp
يۈردى	jyrdi
يۈرسە	jyrsɛ
يۈرۈش	jyryʃ
يۈرۈپ	jyryp
يۈرەك	jyrɛk
يۈزچە	jyzt͡ʃɛ
يۈزۈم	jyzym
يۈسۈپ	jysyp
يۈگۈر	jyɡyr
يېتىم	jetim
يېتىپ	jetip
يېتەر	jetɛr
يېرىم	jerim
يېزىپ	jezip
يېشىل	jeʃil
يېغىن	jeʁin
يېغىپ	jeʁip
يېقىن	jeqin
يېقىپ	jeqip
يېنىك	jenik
يېنىپ	jenip
يېنىڭ	jeniŋ
يېيېپ	jejep
يېڭىش	jeŋiʃ
يېگەن	jeɡɛn
يەتتى	jɛtti
يەتتە	jɛttɛ
يەردە	jɛrdɛ
يەرنى	jɛrni
يەرگە	jɛrɡɛ
يەسلى	jɛsli
يەلىك	jɛlik
يەيدۇ	jɛjdu
يەيچۇ	jɛjt͡ʃu
يەپتۇ	jɛptu
پاخال	paχal
پاختا	paχta
پاراڭ	paraŋ
پارغا	parʁa
پارىژ	pariʒ
پارپا	parpa
پارچە	part͡ʃɛ
پاكار	pakar
پاكىت	pakit
پاكىز	pakiz
پالتا	palta
پايدا	pajda
پوستى	posti
پولنى	polni
پويىز	pojiz
پوچتا	pot͡ʃta
پىشاڭ	piʃaŋ
پىكاپ	pikap
پىكىر	pikir
پۇتۇم	putum
پۇراق	puraq
پۇراپ	purap
پۇشۇپ	puʃup
پۇلغا	pulʁa
پۇلنى	pulni
پۇچۇق	put͡ʃuq
پۈتتى	pytti
پۈتۈن	pytyn
پۈكۈپ	pykyp
پېئىل	peil
پېتىپ	petip
پېتېر	peter
پەرقى	pɛrqi
پەرۋا	pɛrwa
پەسكە	pɛskɛ
پەسلى	pɛsli
پەسىل	pɛsil
پەشنى	pɛʃni
پەقەت	pɛqɛt
پەنگە	pɛnɡɛ
پەيدا	pɛjda
چاغدا	t͡ʃaʁda
چاپان	t͡ʃapan
چاچما	t͡ʃat͡ʃma
چاۋاك	t͡ʃawak
چوقۇم	t͡ʃoqum
چوكان	t͡ʃokan
چولام	t͡ʃolam
چىباڭ	t͡ʃibaŋ
چىداپ	t͡ʃidap
چىراغ	t͡ʃiraʁ
چىراق	t͡ʃiraq
چىراي	t͡ʃiraj
چىغىر	t͡ʃiʁir
چىقتى	t͡ʃiqti
چىقسا	t͡ʃiqsa
چىقىش	t͡ʃiqiʃ
چىقىپ	t͡ʃiqip
چىكىپ	t͡ʃikip
چىلان	t͡ʃilan
چىلاپ	t͡ʃilap
چىلىم	t͡ʃilim
چىڭقى	t͡ʃiŋqi
چىۋىن	t͡ʃiwin
چۆكۈپ	t͡ʃøkyp
چۆمدى	t͡ʃømdi
چۆچۈپ	t͡ʃøt͡ʃyp
چۆچەك	t͡ʃøt͡ʃɛk
چۆگۈن	t͡ʃøɡyn
چۇقان	t͡ʃuqan
چۈشتى	t͡ʃyʃti
چۈشتە	t͡ʃyʃtɛ
چۈشۈم	t͡ʃyʃym
چۈشۈپ	t͡ʃyʃyp
چۈنكى	t͡ʃynki
چۈچۈك	t͡ʃyt͡ʃyk
چېتىپ	t͡ʃetip
چېكىپ	t͡ʃekip
چېلىپ	t͡ʃelip
چېنىپ	t͡ʃenip
چېپىپ	t͡ʃepip
چېچىپ	t͡ʃet͡ʃip
چېچەك	t͡ʃet͡ʃɛk
چېچەن	t͡ʃet͡ʃɛn
چەتتە	t͡ʃɛttɛ
چەتكە	t͡ʃɛtkɛ
چەكتى	t͡ʃɛkti
ژىننى	ʒinni
گازغا	ɡazʁa
گىلاس	ɡilas
گۆھەر	ɡøhɛr
گۇمان	ɡuman
گۈرۈچ	ɡyryt͡ʃ
گۈزەل	ɡyzɛl
گۈلنى	ɡylni
گۈلگە	ɡylɡɛ
گېزىت	ɡezit
گېلەم	ɡelɛm
گېپىم	ɡepim
گەرچە	ɡɛrt͡ʃɛ
گەپمۇ	ɡɛpmu
گەپنى	ɡɛpni
ھاجىپ	had͡ʒip
ھارۋا	harwa
ھازىر	hazir
ھاسىل	hasil
ھالال	halal
ھالدا	halda
ھالغا	halʁa
ھالەت	halɛt
ھامان	haman
ھايات	hajat
ھايال	hajal
ھاپاش	hapaʃ
ھورغا	horʁa
ھوزۇر	hozur
ھوسۇل	hosul
ھويلا	hojla
ھۆسىن	høsin
ھۆكۈم	høkym
ھۆپۈپ	høpyp
ھۈنەر	hynɛr
ھېرىپ	herip
ھەتتا	hɛtta
ھەدەپ	hɛdɛp
ھەسسە	hɛssɛ
ھەسەل	hɛsɛl
ھەققى	hɛqqi
ھەمدە	hɛmdɛ
ھەممە	hɛmmɛ
ۋاراق	waraq
ۋارىس	waris
ۋاقتى	waqti
ۋاقىت	waqit
ۋاپات	wapat
ۋۇكۇڭ	wukuŋ
ۋېتكا	wetka
ۋەتەن	wɛtɛn
ۋەزىر	wɛzir
ۋەزىن	wɛzin
ئۇلۇغ---كىچىك	uluʁ---kit͡ʃik
خىلمۇ--خىل	χilmu--χil
چۈشتى-دە	t͡ʃyʃti-dɛ
ئېگىز-پەس	eɡiz-pɛs
جۇڭگو-چەت_ئەل_شېرىكچىلىكىدىكى	d͡ʒuŋɡo-t͡ʃɛt_ɛl_ʃerikt͡ʃilikidiki
ئانچە-مۇنچە	ant͡ʃɛ-munt͡ʃɛ
ئىلىم-پەننى	ilim-pɛnni
سوراپ-سوراپ	sorap-sorap
سوزۇپ-سوزۇپ	sozup-sozup
قاراپ-قاراپ	qarap-qarap
كېيىم-كېچەك	kejim-ket͡ʃɛk
بىلىپ-بىلمەي	bilip-bilmɛj
تالاش-تارتىش	talaʃ-tartiʃ
كېيىم-كېچەككە	kejim-ket͡ʃɛkkɛ
يىراق-يېقىنغا	jiraq-jeqinʁa
يېمەك-ئىچمىكى	jemɛk-it͡ʃmiki
ئارقا-ئارقىدىن	arqa-arqidin
پولات-تۆمۈرلەر	polat-tømyrlɛr
ئۇرۇق-تۇغقانلىق	uruq-tuʁqanliq
تەلىم-تەربىيىنىڭ	tɛlim-tɛrbijiniŋ
مېھىر-مۇھەببەتكە	mehir-muhɛbbɛtkɛ
يىراق-يىراقلارغا	jiraq-jiraqlarʁa
ئۇرۇق-تۇغقانچىلىق	uruq-tuʁqant͡ʃiliq
پارتا-ئورۇندۇقلار	parta-orunduqlar
ئۇرۇق-تۇغقانلىرىڭنىڭ	uruq-tuʁqanliriŋniŋ
ئەستە_چىڭ_تۇتۇش	ɛstɛ_t͡ʃiŋ_tutuʃ
دېڭىز_بويى	deŋiz_boji
جۇڭگو_خەلق_ئىگىلىكى_تەتقىقات_ئورنىنىڭ	d͡ʒuŋɡo_χɛlq_iɡiliki_tɛtqiqat_orniniŋ
بولسا_كېرەك	bolsa_kerɛk
بىلەن_بىللە	bilɛn_billɛ
قەدەم_قويدى	qɛdɛm_qojdi
چۈشۈپ_قېلىش	t͡ʃyʃyp_qeliʃ
سەھەر_سائەت_2_دىن_40_مىنۇت_ئۆتكەندە	sɛhɛr_saɛt_2_din_40_minut_øtkɛndɛ
خۇاشى_شەھەر_گېزىتى	χuaʃi_ʃɛhɛr_ɡeziti
ئۈمىد_قىلغان	ymid_qilʁan
تۆۋەن_بولۇشى	tøwɛn_boluʃi
كۈشەپ_قويىشى	kyʃɛp_qojiʃi
ئۇنىڭ_ئۈستىگە	uniŋ_ystiɡɛ
داجىپ_بولغىچە	dad͡ʒip_bolʁit͡ʃɛ
دېرەك_بەرسىمۇ	derɛk_bɛrsimu
زىيان_تارتىدۇ	zijan_tartidu
پايدا_ئېلىشقا	pajda_eliʃqa
توغرا_كەلگەچكە	toʁra_kɛlɡɛt͡ʃkɛ
جاۋاب_قايتۇردى	d͡ʒawab_qajturdi
كۆزدە_تۇتقاندا	køzdɛ_tutqanda
جۇڭگو_خەلقئارا_مەسىلىلىرى_تەتقىقات_ئورنىدىكى	d͡ʒuŋɡo_χɛlqara_mɛsililiri_tɛtqiqat_ornidiki
قەدەم_ئېلىۋېتىپ	qɛdɛm_eliwetip
ئائىلە	ailɛ
ئابىدە	abidɛ
ئاتتىم	attim
ئاتتىن	attin
ئاتلاپ	atlap
ئاتمىش	atmiʃ
ئاتنىڭ	atniŋ
ئاتىمۇ	atimu
ئاخشام	aχʃam
ئاخىرى	aχiri
ئاددىي	addij
ئادىتى	aditi
ئارتۇق	artuq
ئارلاپ	arlap
ئارىغا	ariʁa
ئارچېر	art͡ʃer
ئازادە	azadɛ
ئازغان	azʁan
ئاسمان	asman
ئاشقان	aʃqan
ئاشلىق	aʃliq
ئاغرىپ	aʁrip
ئاغىنە	aʁinɛ
ئاكىسى	akisi
ئاكىلا	akila
ئالاقە	alaqɛ
ئالتۇن	altun
ئالداپ	aldap
ئالدىم	aldim
ئالدىڭ	aldiŋ
ئالسام	alsam
ئالغان	alʁan
ئالغاچ	alʁat͡ʃ
ئالغىن	alʁin
ئالقىش	alqiʃ
ئالىدۇ	alidu
ئالىمى	alimi
ئامراق	amraq
ئاندىن	andin
ئانىسى	anisi
ئانىغا	aniʁa
ئايالى	ajali
ئايخان	ajχan
ئايرىپ	ajrip
ئايلار	ajlar
ئاينىڭ	ajniŋ
ئايىغى	ajiʁi
ئايىقى	ajiqi
ئاپئاق	apaq
ئاپىسى	apisi
ئاپپاق	appaq
ئاچقان	at͡ʃqan
ئاچقۇچ	at͡ʃqut͡ʃ
ئاچلىق	at͡ʃliq
ئاچماي	at͡ʃmaj
ئاچچىق	at͡ʃt͡ʃiq
ئاڭلاپ	aŋlap
ئاڭلاڭ	aŋlaŋ
ئاۋازى	awazi
ئاۋۋال	awwal
ئوبدان	obdan
ئوتتۇز	ottuz
ئوتتەك	ottɛk
ئوتلاپ	otlap
ئوخشاش	oχʃaʃ
ئوخشاپ	oχʃap
ئورتاق	ortaq
ئورمان	orman
ئورناپ	ornap
ئوغلاق	oʁlaq
ئوغلان	oʁlan
ئوغلۇم	oʁlum
ئوقتەك	oqtɛk
ئوقنىڭ	oqniŋ
ئوقۇسا	oqusa
ئوقۇڭا	oquŋa
ئويغاق	ojʁaq
ئويغۇر	ojʁur
ئويلاش	ojlaʃ
ئويلاپ	ojlap
ئويناق	ojnaq
ئويناپ	ojnap
ئويۇنى	ojuni
ئىئانە	ianɛ
ئىتتىك	ittik
ئىخلاس	iχlas
ئىدىغۇ	idiʁu
ئىزادا	izada
ئىزدەپ	izdɛp
ئىزلار	izlar
ئىزىغا	iziʁa
ئىزىنى	izini
ئىزچىل	izt͡ʃil
ئىسسىق	issiq
ئىسسىپ	issip
ئىسمىڭ	ismiŋ
ئىشتان	iʃtan
ئىشتىن	iʃtin
ئىشلار	iʃlar
ئىشلەش	iʃlɛʃ
ئىشلەپ	iʃlɛp
ئىشنىڭ	iʃniŋ
ئىشىغا	iʃiʁa
ئىشىنى	iʃini
ئىشچان	iʃt͡ʃan
ئىشەنچ	iʃɛnt͡ʃ
ئىلغار	ilʁar
ئىللىق	illiq
ئىلمىي	ilmij
ئىلىغا	iliʁa
ئىلىمى	ilimi
ئىنكاس	inkas
ئىپادە	ipadɛ
ئىچكەچ	it͡ʃkɛt͡ʃ
ئىچىدۇ	it͡ʃidu
ئىچىدە	it͡ʃidɛ
ئىچىگە	it͡ʃiɡɛ
ئىگىسى	iɡisi
ئۆتتۈڭ	øttyŋ
ئۆتكۈر	øtkyr
ئۆتكەن	øtkɛn
ئۆتمەي	øtmɛj
ئۆردەك	ørdɛk
ئۆركەش	ørkɛʃ
ئۆرلەپ	ørlɛp
ئۆزىدە	øzidɛ
ئۆزىلا	øzila
ئۆزىمۇ	øzimu
ئۆزىنى	øzini
ئۆزىگە	øziɡɛ
ئۆستەڭ	østɛŋ
ئۆسكەن	øskɛn
ئۆكسۈپ	øksyp
ئۆلچەپ	ølt͡ʃɛp
ئۆلۈمى	ølymi
ئۆمرۈم	ømrym
ئۆيدىن	øjdin
ئۆيلەر	øjlɛr
ئۆينىڭ	øjniŋ
ئۆيىدە	øjidɛ
ئۆيىگە	øjiɡɛ
ئۆچكەن	øt͡ʃkɛn
ئۆگۈنى	øɡyni
ئۇخلاش	uχlaʃ
ئۇخلاپ	uχlap
ئۇرغۇپ	urʁup
ئۇستاز	ustaz
ئۇسسۇل	ussul
ئۇششاق	uʃʃaq
ئۇقسام	uqsam
ئۇنتۇپ	untup
ئۇنداق	undaq
ئۇنىمۇ	unimu
ئۇنۋان	unwan
ئۇيغۇر	ujʁur
ئۇچتەك	ut͡ʃtɛk
ئۇچراپ	ut͡ʃrap
ئۇچىدا	ut͡ʃida
ئۇچىغا	ut͡ʃiʁa
ئۇۋىدا	uwida
ئۇۋىسى	uwisi
ئۇۋىقى	uwiqi
ئۈستەل	ystɛl
ئۈششۈپ	yʃʃyp
ئۈنسىز	ynsiz
ئۈنلۈك	ynlyk
ئۈنۈمى	ynymi
ئېتىشى	etiʃi
ئېتىنى	etini
ئېسىدە	esidɛ
ئېقىمى	eqimi
ئېقىنى	eqini
ئېيتاي	ejtaj
ئېيتتى	ejtti
ئېيتىپ	ejtip
ئېيتىڭ	ejtiŋ
ئېيىدا	ejida
ئېپىنى	epini
ئەتراپ	ɛtrap
ئەتكەن	ɛtkɛn
ئەتىسى	ɛtisi
ئەتىكى	ɛtiki
ئەجرىڭ	ɛd͡ʒriŋ
ئەجىبا	ɛd͡ʒiba
ئەجەبا	ɛd͡ʒɛba
ئەخلاق	ɛχlaq
ئەخلەت	ɛχlɛt
ئەخمەت	ɛχmɛt
ئەخمەق	ɛχmɛq
ئەردۇر	ɛrdur
ئەرزان	ɛrzan
ئەركىن	ɛrkin
ئەركەك	ɛrkɛk
ئەرلەر	ɛrlɛr
ئەرنىڭ	ɛrniŋ
ئەسلىي	ɛslij
ئەسلەپ	ɛslɛp
ئەسنەپ	ɛsnɛp
ئەسۋاب	ɛswab
ئەللىك	ɛllik
ئەمىسە	ɛmisɛ
ئەمگەك	ɛmɡɛk
ئەينەك	ɛjnɛk
ئەپسۇس	ɛpsus
ئەپلىك	ɛplik
ئەھۋال	ɛhwal
ئەۋلات	ɛwlat
ئەۋلاد	ɛwlad
باردىم	bardim
باردۇق	barduq
بارسۇن	barsun
بارغان	barʁan
بارغىن	barʁin
بارغۇم	barʁum
بارلىق	barliq
بارماي	barmaj
بارىدۇ	baridu
بارىچە	barit͡ʃɛ
بازىرى	baziri
باسقان	basqan
باشتىن	baʃtin
باشلاپ	baʃlap
باشلىق	baʃliq
باشنىڭ	baʃniŋ
باغلار	baʁlar
باغلاپ	baʁlap
باغنىڭ	baʁniŋ
باقتىم	baqtim
باقسام	baqsam
باققان	baqqan
باققۇم	baqqum
باقىدۇ	baqidu
بالدۇر	baldur
بالىسى	balisi
بالىغا	baliʁa
بالىمۇ	balimu
بالىنى	balini
بايرام	bajram
بايقاش	bajqaʃ
بايقاپ	bajqap
بايلىق	bajliq
بايىقى	bajiqi
باھادا	bahada
بورسوق	borsoq
بورسۇق	borsuq
بوستان	bostan
بوشىدى	boʃidi
بولدۇق	bolduq
بولدۇم	boldum
بولدۇڭ	bolduŋ
بولساق	bolsaq
بولسام	bolsam
بولساڭ	bolsaŋ
بولسۇن	bolsun
بولغان	bolʁan
بولغاي	bolʁaj
بولماس	bolmas
بولماي	bolmaj
بولىدۇ	bolidu
بولۇشى	boluʃi
بويلۇق	bojluq
بويىدا	bojida
بويىغا	bojiʁa
بويىچە	bojit͡ʃɛ
بىباھا	bibaha
بىرئاز	biraz
بىرخىل	birχil
بىردىن	birdin
بىردەك	birdɛk
بىردەم	birdɛm
بىركىم	birkim
بىرلەپ	birlɛp
بىرىدە	biridɛ
بىرىنى	birini
بىرىگە	biriɡɛ
بىرەرى	birɛri
بىزدىن	bizdin
بىزنىڭ	bizniŋ
بىلدىم	bildim
بىلسەڭ	bilsɛŋ
بىلمەي	bilmɛj
بىلىدۇ	bilidu
بىلىشى	biliʃi
بىلگۈم	bilɡym
بىلگەن	bilɡɛn
بىنادا	binada
بىچارە	bit͡ʃarɛ
بىھۇدە	bihudɛ
بۆرىنى	børini
بۆرىگە	børiɡɛ
بۆشۈكى	bøʃyki
بۇدرۇق	budruq
بۇزماي	buzmaj
بۇغداي	buʁdaj
بۇلتۇر	bultur
بۇلدۇق	bulduq
بۇلغاش	bulʁaʃ
بۇلۇشى	buluʃi
بۇنداق	bundaq
بۇيرۇق	bujruq
بۇيىچە	bujit͡ʃɛ
بېرىدۇ	beridu
بېرىڭا	beriŋa
بېشىدا	beʃida
بېشىغا	beʃiʁa
بېشىنى	beʃini
بېقىڭا	beqiŋa
بېيجىڭ	bejd͡ʒiŋ
بەدىنى	bɛdini
بەردىم	bɛrdim
بەردىڭ	bɛrdiŋ
بەردۇق	bɛrduq
بەرسەم	bɛrsɛm
بەرسەڭ	bɛrsɛŋ
بەرمەي	bɛrmɛj
بەرگنى	bɛrɡni
بەرگەن	bɛrɡɛn
بەزىدە	bɛzidɛ
بەكرەك	bɛkrɛk
بەلكىم	bɛlkim
تاتلىق	tatliq
تارتتى	tartti
تارتىش	tartiʃ
تارتىپ	tartip
تاشتىن	taʃtin
تاشلار	taʃlar
تاشلاش	taʃlaʃ
تاشلاپ	taʃlap
تاشلىق	taʃliq
تاشنىڭ	taʃniŋ
تاغدىن	taʁdin
تاغلار	taʁlar
تاقلاپ	taqlap
تالدىن	taldin
تاماشا	tamaʃa
تاماكا	tamaka
تامدەك	tamdɛk
تاملىق	tamliq
تانىنى	tanini
تايدەك	tajdɛk
تايىقى	tajiqi
تاپقان	tapqan
تاپىدۇ	tapidu
توختام	toχtam
توختاپ	toχtap
توخۇنى	toχuni
توردىن	tordin
تورغاي	torʁaj
تورىدا	torida
تورىغا	toriʁa
توشقان	toʃqan
توغرۇل	toʁrul
توققۇز	toqquz
تولغاپ	tolʁap
تولىمۇ	tolimu
تولىيە	tolijɛ
تولۇقى	toluqi
تونىنى	tonini
تويغان	tojʁan
توپلاپ	toplap
توپنىڭ	topniŋ
توپىغا	topiʁa
توڭلاپ	toŋlap
توۋلاپ	towlap
تىترەپ	titrɛp
تىزىغا	tiziʁa
تىكىچى	tikit͡ʃi
تىللار	tillar
تىللدى	tilldi
تىلىغا	tiliʁa
تىمتاس	timtas
تىمسال	timsal
تىنسىز	tinsiz
تىنماي	tinmaj
تىگىدە	tiɡidɛ
تۆشلۈك	tøʃlyk
تۇردۇم	turdum
تۇرسام	tursam
تۇرسۇن	tursun
تۇرغان	turʁan
تۇرمۇش	turmuʃ
تۇرىدۇ	turidu
تۇرپان	turpan
تۇرۇشى	turuʃi
تۇرۇڭا	turuŋa
تۇرۇڭە	turuŋɛ
تۇشلۇق	tuʃluq
تۇغقان	tuʁqan
تۇلىمۇ	tulimu
تۇڭىغا	tuŋiʁa
تۈرتكە	tyrtkɛ
تۈركۈم	tyrkym
تۈرلۈك	tyrlyk
تۈرىمۇ	tyrimu
تۈرگەن	tyrɡɛn
تۈزۈمى	tyzymi
تۈسىگە	tysiɡɛ
تۈپتۈز	typtyz
تۈگىدى	tyɡidi
تۈگۈنى	tyɡyni
تۈۋرۈك	tywryk
تۈۋىدە	tywidɛ
تۈۋىگە	tywiɡɛ
تېببىي	tebbij
تېخنىك	teχnik
تېخىمۇ	teχimu
تېخىچە	teχit͡ʃɛ
تېشدىن	teʃdin
تېلفۇن	telfun
تېگىلا	teɡila
تېگىنى	teɡini
تېگىگە	teɡiɡɛ
تەتبىق	tɛtbiq
تەتقىق	tɛtqiq
تەركىپ	tɛrkip
تەرلەپ	tɛrlɛp
تەقدىم	tɛqdim
تەكلىپ	tɛklip
تەلىيى	tɛliji
تەمىنى	tɛmini
تەگكەن	tɛɡkɛn
تەھدىت	tɛhdit
تەھسىل	tɛhsil
جابدۇپ	d͡ʒabdup
جازاسى	d͡ʒazasi
جازىسى	d͡ʒazisi
جايلار	d͡ʒajlar
جايىدا	d͡ʒajida
جايىغا	d͡ʒajiʁa
جاپاسى	d͡ʒapasi
جاۋدۇڭ	d͡ʒawduŋ
جوھراي	d͡ʒohraj
جىددىي	d͡ʒiddij
جىمجىت	d͡ʒimd͡ʒit
جۇدۇنى	d͡ʒuduni
جۇشقۇن	d͡ʒuʃqun
جۇڭخۇا	d͡ʒuŋχua
جۈرئەت	d͡ʒyrɛt
جەدۋەل	d͡ʒɛdwɛl
جەزمەن	d͡ʒɛzmɛn
جەمئىي	d͡ʒɛmij
خاتاغا	χataʁa
خادىمى	χadimi
خوتۇنى	χotuni
خورلاش	χorlaʃ
خورلۇق	χorluq
خورىنى	χorini
خولېۋا	χolewa
خىتابى	χitabi
خىزمەت	χizmɛt
خىلۋەت	χilwɛt
خىيالى	χijali
خۇشتار	χuʃtar
خۇمپەر	χumpɛr
خېلىلا	χelila
خېڭدىن	χeŋdin
خەتنىڭ	χɛtniŋ
خەزىنە	χɛzinɛ
خەقنىڭ	χɛqniŋ
خەينەن	χɛjnɛn
خەۋىرى	χɛwiri
دادىسى	dadisi
دارۋىن	darwin
دالىغا	daliʁa
داندىن	dandin
دانىمۇ	danimu
داڭلىق	daŋliq
داۋراڭ	dawraŋ
دوختۇر	doχtur
دوستۇم	dostum
دوغىنى	doʁini
دوكلات	doklat
دولقۇن	dolqun
دىزىزە	dizizɛ
دىققەت	diqqɛt
دىلودا	diloda
دىمىدى	dimidi
دۇباۋا	dubawa
دېرىزە	derizɛ
دېمىسە	demisɛ
دېگىنى	deɡini
دېگىنە	deɡinɛ
دېگىچە	deɡit͡ʃɛ
دەردنى	dɛrdni
دەرىخى	dɛriχi
دەرھال	dɛrhal
دەسسەپ	dɛssɛp
دەسلەپ	dɛslɛp
دەمدىن	dɛmdin
دەمسىز	dɛmsiz
دەيتتى	dɛjtti
دەيسىز	dɛjsiz
دەيسەن	dɛjsɛn
دەيمىز	dɛjmiz
دەيمەن	dɛjmɛn
دەپتەر	dɛptɛr
دەۋردە	dɛwrdɛ
رادىيو	radijo
راستلا	rastla
راستما	rastma
راستمۇ	rastmu
راھىتى	rahiti
رولىنى	rolini
روھلۇق	rohluq
روھنىڭ	rohniŋ
روھىغا	rohiʁa
رىتىمى	ritimi
رۇخسەت	ruχsɛt
رېمونت	remont
رەتلىك	rɛtlik
رەختنى	rɛχtni
رەسمىي	rɛsmij
رەڭدار	rɛŋdar
رەڭلىك	rɛŋlik
رەھمەت	rɛhmɛt
زادىلا	zadila
زالنىڭ	zalniŋ
زاپىسى	zapisi
زاڭلىق	zaŋliq
زوقىنى	zoqini
زومچەك	zomt͡ʃɛk
زىراپە	zirapɛ
زۇلمەت	zulmɛt
زېھنىي	zehnij
ساداسى	sadasi
سارىيى	sariji
ساشاغا	saʃaʁa
ساغلام	saʁlam
سافانى	safani
ساقلاپ	saqlap
سالدىم	saldim
سالساق	salsaq
سالغان	salʁan
سالغاچ	salʁat͡ʃ
سالقىن	salqin
سالماق	salmaq
سانجىپ	sand͡ʒip
سانسىز	sansiz
سانىدى	sanidi
سانىنى	sanini
سانىيە	sanijɛ
سايرام	sajram
سايلاش	sajlaʃ
سورىدى	soridi
سولتەك	soltɛk
سوۋغات	sowʁat
سىرتتا	sirtta
سىرتقا	sirtqa
سىرتقى	sirtqi
سىرلىق	sirliq
سىرىنى	sirini
سىزدىن	sizdin
سىزنىڭ	sizniŋ
سىغماي	siʁmaj
سىلىدى	silidi
سىلىنى	silini
سىياسى	sijasi
سىپايە	sipajɛ
سىچۇەن	sit͡ʃuɛn
سىڭلىم	siŋlim
سىگۇاڭ	siɡuaŋ
سۆزلەر	søzlɛr
سۆزلەپ	søzlɛp
سۆزىمۇ	søzimu
سۆزىنى	søzini
سۆيگەن	søjɡɛn
سۇلىرى	suliri
سۇلياۋ	suljaw
سۇپىسى	supisi
سۈتتەك	syttɛk
سۈرتتى	syrtti
سۈرىتى	syriti
سۈيىدە	syjidɛ
سۈيىمۇ	syjimu
سۈيىنى	syjini
سۈيىگە	syjiɡɛ
سۈپىتى	sypiti
سېكۇنت	sekunt
سېماسى	semasi
سېمۇنت	semunt
سېپىلى	sepili
سېھرىي	sehrij
سەزمەي	sɛzmɛj
سەزگۈر	sɛzɡyr
سەزگۈڭ	sɛzɡyŋ
سەكرەپ	sɛkrɛp
سەكسەن	sɛksɛn
سەككىز	sɛkkiz
سەنئەت	sɛnɛt
سەندىن	sɛndin
سەيياھ	sɛjjah
سەھىپە	sɛhipɛ
شاتلىق	ʃatliq
شاختىن	ʃaχtin
شارىدا	ʃarida
شارىغا	ʃariʁa
شارىنى	ʃarini
شالنىڭ	ʃalniŋ
شامنىڭ	ʃamniŋ
شامىلى	ʃamili
شانلىق	ʃanliq
شايىگە	ʃajiɡɛ
شاپتۇل	ʃaptul
شاڭخەي	ʃaŋχɛj
شاھانا	ʃahana
شورلۇق	ʃorluq
شىددەت	ʃiddɛt
شىرەنى	ʃirɛni
شىنجاڭ	ʃind͡ʒaŋ
شۇجىسى	ʃud͡ʒisi
شۇنداق	ʃundaq
شېخىغا	ʃeχiʁa
شېشىدە	ʃeʃidɛ
شەرقىي	ʃɛrqij
شەكسىز	ʃɛksiz
شەكلىم	ʃɛklim
شەكىلى	ʃɛkili
شەمنەم	ʃɛmnɛm
شەھىرى	ʃɛhiri
غايىنى	ʁajini
غۇجمەك	ʁud͡ʒmɛk
غېمىدە	ʁemidɛ
غەربىي	ʁɛrbij
غەلىتە	ʁɛlitɛ
غەمكىن	ʁɛmkin
غەيرىي	ʁɛjrij
فىلىمى	filimi
فۇجيەن	fud͡ʒjɛn
فېننىگ	fenniɡ
قاتتىق	qattiq
قاتناش	qatnaʃ
قارلار	qarlar
قارىدى	qaridi
قارىسا	qarisa
قارىسى	qarisi
قارىشى	qariʃi
قاسىمى	qasimi
قاقماي	qaqmaj
قالتىس	qaltis
قالدىم	qaldim
قالدۇق	qalduq
قالسام	qalsam
قالسۇن	qalsun
قالغان	qalʁan
قالماي	qalmaj
قالىدۇ	qalidu
قانداق	qandaq
قانغان	qanʁan
قانىتى	qaniti
قانىلى	qanili
قايتتى	qajtti
قايتىپ	qajtip
قايرىپ	qajrip
قايناق	qajnaq
قاينام	qajnam
قاپلاپ	qaplap
قاچىدا	qat͡ʃida
قاڭقىپ	qaŋqip
قورالى	qorali
قورشاۋ	qorʃaw
قورقۇپ	qorqup
قورچاق	qort͡ʃaq
قوشقان	qoʃqan
قوغداش	qoʁdaʃ
قوغداپ	qoʁdap
قولدىن	qoldin
قولىدا	qolida
قولىغا	qoliʁa
قولىنى	qolini
قونچاق	qont͡ʃaq
قويدۇم	qojdum
قويساق	qojsaq
قويغان	qojʁan
قويلار	qojlar
قويىدۇ	qojidu
قويۇڭا	qojuŋa
قوپقان	qopqan
قوچقار	qot͡ʃqar
قوڭغۇز	qoŋʁuz
قىرىدا	qirida
قىرىغا	qiriʁa
قىزغىن	qizʁin
قىزغۇچ	qizʁut͡ʃ
قىزلار	qizlar
قىزنىڭ	qizniŋ
قىزىغا	qiziʁa
قىزىنى	qizini
قىزچاق	qizt͡ʃaq
قىسمەن	qismɛn
قىشلىق	qiʃliq
قىشنىڭ	qiʃniŋ
قىشىچە	qiʃit͡ʃɛ
قىلدىم	qildim
قىلدىڭ	qildiŋ
قىلدۇق	qilduq
قىلسام	qilsam
قىلساڭ	qilsaŋ
قىلغان	qilʁan
قىلغاچ	qilʁat͡ʃ
قىلغىن	qilʁin
قىلماق	qilmaq
قىلماي	qilmaj
قىلىدۇ	qilidu
قىلىشى	qiliʃi
قىممەت	qimmɛt
قىيسىق	qijsiq
قىپتۇق	qiptuq
قۇتىسى	qutisi
قۇدرەت	qudrɛt
قۇربان	qurban
قۇرغاق	qurʁaq
قۇشقاچ	quʃqat͡ʃ
قۇشلار	quʃlar
قۇلۇلە	qululɛ
قۇملۇق	qumluq
قېشىغا	qeʃiʁa
قېلىشى	qeliʃi
قېنىنى	qenini
قەتئىي	qɛtij
قەستەن	qɛstɛn
قەشقەر	qɛʃqɛr
قەلبگە	qɛlbɡɛ
قەنتكە	qɛntkɛ
قەنتنى	qɛntni
قەيسەر	qɛjsɛr
كارتون	karton
كاسىدا	kasida
كاشىلا	kaʃila
كاككۇك	kakkuk
كاككۈك	kakkyk
كراينى	krajni
كوچىدا	kot͡ʃida
كوچىسى	kot͡ʃisi
كوچىغا	kot͡ʃiʁa
كوچىمۇ	kot͡ʃimu
كىردۇق	kirduq
كىرمەي	kirmɛj
كىرىدۇ	kiridu
كىرىشى	kiriʃi
كىرپىك	kirpik
كىرگىن	kirɡin
كىرگەن	kirɡɛn
كىشلىك	kiʃlik
كىشلەر	kiʃlɛr
كىشىنى	kiʃini
كىشىنڭ	kiʃinŋ
كىشىگە	kiʃiɡɛ
كىمنىڭ	kimniŋ
كىنودا	kinoda
كىيسۇن	kijsun
كىيىشى	kijiʃi
كىيگەن	kijɡɛn
كۆردۈم	kørdym
كۆرسەت	kørsɛt
كۆركەم	kørkɛm
كۆرمەي	kørmɛj
كۆرىدۇ	køridu
كۆرگۈم	kørɡym
كۆرگەن	kørɡɛn
كۆزدىن	køzdin
كۆزلەر	køzlɛr
كۆزنىڭ	køzniŋ
كۆزىنى	køzini
كۆزىگە	køziɡɛ
كۆكتات	køktat
كۆللەر	køllɛr
كۆلنىڭ	kølniŋ
كۆلىگە	køliɡɛ
كۆلچەك	kølt͡ʃɛk
كۆپجۈپ	køpd͡ʒyp
كۆپكۆك	køpkøk
كۆپكۈك	køpkyk
كۆچىتى	køt͡ʃiti
كۆڭلۈم	køŋlym
كۆڭلەك	køŋlɛk
كۆۋرۈك	køwryk
كۇپلېت	kuplet
كۇڭچيۇ	kuŋt͡ʃju
كۈتتۈم	kyttym
كۈتىدۇ	kytidu
كۈزلۈك	kyzlyk
كۈزنىڭ	kyzniŋ
كۈلدەك	kyldɛk
كۈلسۇن	kylsun
كۈلكەڭ	kylkɛŋ
كۈلپەت	kylpɛt
كۈلگىن	kylɡin
كۈلگۈم	kylɡym
كۈندىن	kyndin
كۈندۈز	kyndyz
كۈنلۈك	kynlyk
كۈنلەر	kynlɛr
كۈننىڭ	kynniŋ
كۈنىلا	kynila
كۈنىنى	kynini
كۈچلۈك	kyt͡ʃlyk
كۈچنىڭ	kyt͡ʃniŋ
كېتىدۇ	ketidu
كېتىشى	ketiʃi
كېلىدۇ	kelidu
كېلىشى	keliʃi
كېچىدە	ket͡ʃidɛ
كېچىسى	ket͡ʃisi
كېچىنى	ket͡ʃini
كېچىچە	ket͡ʃit͡ʃɛ
كەتتى،	kɛtti،
كەتتىم	kɛttim
كەتتۇق	kɛttuq
كەتسۇن	kɛtsun
كەتكەن	kɛtkɛn
كەتمەي	kɛtmɛj
كەلدىم	kɛldim
كەلدۇق	kɛlduq
كەلسەك	kɛlsɛk
كەلسەم	kɛlsɛm
كەلكۈن	kɛlkyn
كەلگەن	kɛlɡɛn
كەمتەر	kɛmtɛr
كەمچىل	kɛmt͡ʃil
كەنتتە	kɛnttɛ
كەنتكە	kɛntkɛ
كەندىر	kɛndir
كەپسىز	kɛpsiz
كەچتىڭ	kɛt͡ʃtiŋ
كەچتۇق	kɛt͡ʃtuq
كەچكەن	kɛt͡ʃkɛn
كەچلىك	kɛt͡ʃlik
لوندون	london
لېۋىگە	lewiɡɛ
لەرزان	lɛrzan
لەززەت	lɛzzɛt
لەشلەر	lɛʃlɛr
لەغمەن	lɛʁmɛn
لەيلەش	lɛjlɛʃ
لەيلەپ	lɛjlɛp
لەگلەك	lɛɡlɛk
ماددىي	maddij
ماشىنا	maʃina
مامكاپ	mamkap
مايمۇن	majmun
مايىقى	majiqi
ماڭدىم	maŋdim
ماڭغان	maŋʁan
ماڭماي	maŋmaj
موللاق	mollaq
مىرشاپ	mirʃap
مىللەت	millɛt
مىليون	miljon
مىھمان	mihman
مۆجىزە	mød͡ʒizɛ
مۆلدۈر	møldyr
مۇخلار	muχlar
مۇدىرى	mudiri
مۇزدەك	muzdɛk
مۇزلار	muzlar
مۇزلاپ	muzlap
مۇزىكا	muzika
مۇمكىن	mumkin
مۇنارى	munari
مۇنداق	mundaq
مۇڭلۇق	muŋluq
مۇھتاج	muhtad͡ʒ
مۇھىمى	muhimi
مۈشكۈل	myʃkyl
مۈڭگۈز	myŋɡyz
مېنىمۇ	menimu
مېڭىشى	meŋiʃi
مېھرىڭ	mehriŋ
مېھمان	mehman
مېۋىگە	mewiɡɛ
مەبلەغ	mɛblɛʁ
مەجبۇر	mɛd͡ʒbur
مەخسۇس	mɛχsus
مەخلۇق	mɛχluq
مەركەز	mɛrkɛz
مەرھۇم	mɛrhum
مەزكۇر	mɛzkur
مەزمۇن	mɛzmun
مەزگىل	mɛzɡil
مەسئۇل	mɛsul
مەسلەن	mɛslɛn
مەسىلە	mɛsilɛ
مەشرەپ	mɛʃrɛp
مەشغۇل	mɛʃʁul
مەشھۇر	mɛʃhur
مەشەدە	mɛʃɛdɛ
مەغرۇر	mɛʁrur
مەغلۇپ	mɛʁlup
مەكتەپ	mɛktɛp
مەمنۇن	mɛmnun
مەندىن	mɛndin
مەندەك	mɛndɛk
مەنسۈپ	mɛnsyp
مەنسەپ	mɛnsɛp
مەننىڭ	mɛnniŋ
مەنىنى	mɛnini
مەيدان	mɛjdan
مەيلىم	mɛjlim
مەپتۇن	mɛptun
مەڭدەپ	mɛŋdɛp
مەھرۇم	mɛhrum
مەھكەم	mɛhkɛm
مەھمۇد	mɛhmud
مەۋجۇت	mɛwd͡ʒut
نالىسى	nalisi
نامرات	namrat
نامسىز	namsiz
نامىغا	namiʁa
نامىمۇ	namimu
نامىنى	namini
ناننىڭ	nanniŋ
ناھىيە	nahijɛ
ناۋادا	nawada
نورغۇن	norʁun
نورمال	normal
نۆۋىتى	nøwiti
نۇردىن	nurdin
نۇرغۇن	nurʁun
نۇرلار	nurlar
نۇرلۇق	nurluq
نۇرنىڭ	nurniŋ
نۇرىغا	nuriʁa
نۇرىنى	nurini
نېرىدا	nerida
نېرىقى	neriqi
نېمىلا	nemila
نېمىنى	nemini
نەتىجە	nɛtid͡ʒɛ
نەرسەڭ	nɛrsɛŋ
نەزىرى	nɛziri
نەشپۈت	nɛʃpyt
نەملىك	nɛmlik
نەگىچە	nɛɡit͡ʃɛ
نەۋرەم	nɛwrɛm
ياتقان	jatqan
يادلاپ	jadlap
ياردەم	jardɛm
يارقىن	jarqin
يازلىق	jazliq
يازنىڭ	jazniŋ
ياسىدى	jasidi
ياشتىن	jaʃtin
ياشلار	jaʃlar
ياشلىق	jaʃliq
ياغلىق	jaʁliq
ياقتىن	jaqtin
يالغان	jalʁan
يالغۇز	jalʁuz
يامغۇر	jamʁur
يانداش	jandaʃ
ياندىم	jandim
يايراپ	jajrap
يايلاق	jajlaq
ياپراق	japraq
يوقتەك	joqtɛk
يوقلاپ	joqlap
يوقىرى	joqiri
يولداش	joldaʃ
يولدىن	joldin
يوللار	jollar
يوللۇق	jolluq
يولنىڭ	jolniŋ
يولىدا	jolida
يولىغا	joliʁa
يوپۇغا	jopuʁa
يىغلاپ	jiʁlap
يىغىنى	jiʁini
يىلدىن	jildin
يىللار	jillar
يىللدا	jillda
يىللىق	jilliq
يىلنىڭ	jilniŋ
يىلىغا	jiliʁa
يىپسىز	jipsiz
يىپلەر	jiplɛr
يىپنىڭ	jipniŋ
يىپىنى	jipini
يىگىتى	jiɡiti
يۇرتۇڭ	jurtuŋ
يۇقىرى	juqiri
يۇلتۇز	jultuz
يۇمران	jumran
يۇڭلۇق	juŋluq
يۈرىكى	jyriki
يۈرگەن	jyrɡɛn
يۈزنىڭ	jyzniŋ
يۈزىدە	jyzidɛ
يۈزىمۇ	jyzimu
يۈزىنى	jyzini
يۈزىگە	jyziɡɛ
يۈكسەك	jyksɛk
يۈكىنى	jykini
يۈەنگە	jyɛnɡɛ
يېتىدۇ	jetidu
يېرىدە	jeridɛ
يېرىمى	jerimi
يېرىگە	jeriɡɛ
يېزدىن	jezdin
يېزىدا	jezida
يېزىسى	jezisi
يېزىنى	jezini
يېسىلا	jesila
يېغىنى	jeʁini
يېقىنى	jeqini
يېنىدا	jenida
يېنىغا	jeniʁa
يېگىلى	jeɡili
يەتتىم	jɛttim
يەتسەڭ	jɛtsɛŋ
يەتكەن	jɛtkɛn
يەردىن	jɛrdin
يەرلىك	jɛrlik
يەرلەر	jɛrlɛr
يەرنىڭ	jɛrniŋ
يەكسان	jɛksan
يەلپۈپ	jɛlpyp
يەنىلا	jɛnila
يەنىمۇ	jɛnimu
يەيسەن	jɛjsɛn
يەيمەن	jɛjmɛn
يەڭگىل	jɛŋɡil
پاتقان	patqan
پاتماي	patmaj
پاتنېت	patnet
پادىچى	padit͡ʃi
پارلاق	parlaq
پارلاپ	parlap
پارنىك	parnik
پارنىڭ	parniŋ
پاششاپ	paʃʃap
پالۋان	palwan
پىسەنت	pisɛnt
پىشقان	piʃqan
پىشكوف	piʃkof
پىشماق	piʃmaq
پىيادە	pijadɛ
پىچىمى	pit͡ʃimi
پۇتىغا	putiʁa
پۇتىنى	putini
پۇرىقى	puriqi
پۇرچاق	purt͡ʃaq
پۈتكەن	pytkɛn
پۈۋلەپ	pywlɛp
پېتىچە	petit͡ʃɛ
پېشىنى	peʃini
پېيىگە	pejiɡɛ
پەدەرى	pɛdɛri
پەرۋاز	pɛrwaz
پەرۋىش	pɛrwiʃ
پەشمىش	pɛʃmiʃ
پەنلەر	pɛnlɛr
پەننىي	pɛnnij
چاخچاق	t͡ʃaχt͡ʃaq
چارىسى	t͡ʃarisi
چاشقان	t͡ʃaʃqan
چاغلار	t͡ʃaʁlar
چاققان	t͡ʃaqqan
چاقلىق	t͡ʃaqliq
چاقماق	t͡ʃaqmaq
چاقناپ	t͡ʃaqnap
چاقىغا	t͡ʃaqiʁa
چالسام	t͡ʃalsam
چالغان	t͡ʃalʁan
چالىدۇ	t͡ʃalidu
چايقاپ	t͡ʃajqap
چوغدىن	t͡ʃoʁdin
چوڭراق	t͡ʃoŋraq
چوڭقۇر	t͡ʃoŋqur
چوڭىنى	t͡ʃoŋini
چىرايى	t͡ʃiraji
چىرىغى	t͡ʃiriʁi
چىشلەپ	t͡ʃiʃlɛp
چىشىنى	t͡ʃiʃini
چىقتىم	t͡ʃiqtim
چىقتۇق	t͡ʃiqtuq
چىققان	t͡ʃiqqan
چىقماي	t͡ʃiqmaj
چىقىدۇ	t͡ʃiqidu
چىللاپ	t͡ʃillap
چىنلىڭ	t͡ʃinliŋ
چۆمدۈم	t͡ʃømdym
چۆمگەن	t͡ʃømɡɛn
چۆپلەر	t͡ʃøplɛr
چۆچۈدى	t͡ʃøt͡ʃydi
چۈشتىن	t͡ʃyʃtin
چۈشتۇق	t͡ʃyʃtuq
چۈشتۈم	t͡ʃyʃtym
چۈشسەم	t͡ʃyʃsɛm
چۈشكەن	t͡ʃyʃkɛn
چۈشلۈك	t͡ʃyʃlyk
چۈشنىڭ	t͡ʃyʃniŋ
چۈشىدۇ	t͡ʃyʃidu
چېغىدا	t͡ʃeʁida
چېچىغا	t͡ʃet͡ʃiʁa
چېچىكى	t͡ʃet͡ʃiki
چېچېكى	t͡ʃet͡ʃeki
چەكسىز	t͡ʃɛksiz
چەكلەش	t͡ʃɛklɛʃ
چەمبەر	t͡ʃɛmbɛr
گوركىي	ɡorkij
گۆشخور	ɡøʃχor
گۆشلەر	ɡøʃlɛr
گۆشىنى	ɡøʃini
گۇۋاچى	ɡuwat͡ʃi
گۈلتاج	ɡyltad͡ʒ
گۈلخان	ɡylχan
گۈلسىز	ɡylsiz
گۈللۈك	ɡyllyk
گۈللەر	ɡyllɛr
گۈلنىڭ	ɡylniŋ
گۈلچىڭ	ɡylt͡ʃiŋ
گۈەنزە	ɡyɛnzɛ
گېپىنى	ɡepini
گېپىگە	ɡepiɡɛ
گەپتىن	ɡɛptin
گەپنىڭ	ɡɛpniŋ
ھاجىتى	had͡ʒiti
ھاجىمۇ	had͡ʒimu
ھارغىن	harʁin
ھاكىمى	hakimi
ھالقىپ	halqip
ھالىتى	haliti
ھالىغا	haliʁa
ھايۋان	hajwan
ھاۋادا	hawada
ھاۋاسى	hawasi
ھاۋانى	hawani
ھوشىغا	hoʃiʁa
ھوشيار	hoʃjar
ھىنگان	hinɡan
ھۆرمەت	hørmɛt
ھۆلدەپ	høldɛp
ھۈنىرى	hyniri
ھېكايە	hekajɛ
ھېلىقى	heliqi
ھېلىلا	helila
ھېلىمۇ	helimu
ھېچكىم	het͡ʃkim
ھەدىيە	hɛdijɛ
ھەربىر	hɛrbir
ھەربىي	hɛrbij
ھەرخىل	hɛrχil
ھەركىم	hɛrkim
ھەركەت	hɛrkɛt
ھەرگىز	hɛrɡiz
ھەقلىق	hɛqliq
ھەمراھ	hɛmrah
ھەيران	hɛjran
ھەيۋەت	hɛjwɛt
ھەۋىسى	hɛwisi
ۋاللەي	wallɛj
ۋايجان	wajd͡ʒan
ۋوگزال	woɡzal
ۋىجدان	wid͡ʒdan
ۋۇجۇدى	wud͡ʒudi
ۋەزىپە	wɛzipɛ
ۋەقەسى	wɛqɛsi
ۋەقەمۇ	wɛqɛmu
ۋەقەنى	wɛqɛni
ۋەھشىي	wɛhʃij
‹‹ئىلى	‹‹ili
بېرىدۇ-دە	beridu-dɛ
قارىدى-دە	qaridi-dɛ
ئوڭغۇل-دوڭغۇل	oŋʁul-doŋʁul
ساگامى-ناداغا	saɡami-nadaʁa
نۇرغۇن-نۇرغۇن	nurʁun-nurʁun
يالماپ-يالماپ	jalmap-jalmap
ھاپىلا-شاپىلا	hapila-ʃapila
يوتقان-كۆرپىلىرى	jotqan-kørpiliri
مالىيە-ئىقتىسادىي	malijɛ-iqtisadij
چۈشتىن_كېيىن	t͡ʃyʃtin_kejin
ئاتالغۇ	atalʁu
ئاتىلىق	atiliq
ئاتىنىڭ	atiniŋ
ئاجايىپ	ad͡ʒajip
ئاجىزمۇ	ad͡ʒizmu
ئاخشىمى	aχʃimi
ئاخىرقى	aχirqi
ئادەتتە	adɛttɛ
ئادەمنى	adɛmni
ئادەمگە	adɛmɡɛ
ئارالدا	aralda
ئارالغا	aralʁa
ئارزۇسى	arzusi
ئارسىدا	arsida
ئارسىغا	arsiʁa
ئارقىدا	arqida
ئارقىغا	arqiʁa
ئارلىقى	arliqi
ئارمىيە	armijɛ
ئارىدىن	aridin
ئارىلاش	arilaʃ
ئارىلاپ	arilap
ئازىيىپ	azijip
ئاساسەن	asasɛn
ئاسانلا	asanla
ئاسانمۇ	asanmu
ئاستىدا	astida
ئاستىغا	astiʁa
ئاسمىنى	asmini
ئاشاتتى	aʃatti
ئاشخانا	aʃχana
ئاشكارە	aʃkarɛ
ئاشۇردى	aʃurdi
ئاشۇرۇش	aʃuruʃ
ئاشۇرۇپ	aʃurup
ئاغزىنى	aʁzini
ئاقاتتى	aqatti
ئاقارتش	aqartʃ
ئاكامغا	akamʁa
ئاكىلىق	akiliq
ئاكىنىڭ	akiniŋ
ئالامەت	alamɛt
ئالتىنى	altini
ئالدىدا	aldida
ئالدىغا	aldiʁa
ئالدىما	aldima
ئالدىنى	aldini
ئالغىلى	alʁili
ئالمىنى	almini
ئالىمەن	alimɛn
ئالىيىپ	alijip
ئاممىۋى	ammiwi
ئانامنى	anamni
ئانىلار	anilar
ئانىمىز	animiz
ئانىنىڭ	aniniŋ
ئايالغا	ajalʁa
ئايالىم	ajalim
ئايىماي	ajimaj
ئاپامنى	apamni
ئاپىرىپ	apirip
ئاچقىنا	at͡ʃqina
ئاچقۇچى	at͡ʃqut͡ʃi
ئاچقۇچە	at͡ʃqut͡ʃɛ
ئاچىماق	at͡ʃimaq
ئاچچىقى	at͡ʃt͡ʃiqi
ئاڭغىچە	aŋʁit͡ʃɛ
ئاڭلىدى	aŋlidi
ئاۋازدا	awazda
ئاۋازنى	awazni
ئاۋغۇست	awʁust
ئاۋۇنىڭ	awuniŋ
ئوتتۇرا	ottura
ئورايدۇ	orajdu
ئورنىدا	ornida
ئورنىغا	orniʁa
ئورۇلۇپ	orulup
ئورۇندا	orunda
ئورۇنغا	orunʁa
ئورۇننى	orunni
ئوغامنى	oʁamni
ئوغلىغا	oʁliʁa
ئوغلىنى	oʁlini
ئوغۇلمۇ	oʁulmu
ئوقىدەك	oqidɛk
ئوقۇتتى	oqutti
ئوقۇشقا	oquʃqa
ئوقۇشنى	oquʃni
ئوقۇغىن	oquʁin
ئوقۇپچۇ	oqupt͡ʃu
ئولجىغا	old͡ʒiʁa
ئومۇمىي	omumij
ئويلىدى	ojlidi
ئويۇننى	ojunni
ئوچاققا	ot͡ʃaqqa
ئوچاقنى	ot͡ʃaqni
ئوڭايلا	oŋajla
ئوڭۇمنى	oŋumni
ئىبارەت	ibarɛt
ئىتايىن	itajin
ئىدىقۇت	idiqut
ئىدىكىن	idikin
ئىزدىدى	izdidi
ئىستىكى	istiki
ئىستىپا	istipa
ئىسمىنى	ismini
ئىشتىنى	iʃtini
ئىشلىرى	iʃliri
ئىشلىسە	iʃlisɛ
ئىشىكنى	iʃikni
ئىشىنىپ	iʃinip
ئىشەنچى	iʃɛnt͡ʃi
ئىقلىمى	iqlimi
ئىككىسى	ikkisi
ئىككىچۇ	ikkit͡ʃu
ئىلكىدە	ilkidɛ
ئىللىدى	illidi
ئىلمىكى	ilmiki
ئىلمىنى	ilmini
ئىلگىرى	ilɡiri
ئىمامنى	imamni
ئىنچىكە	int͡ʃikɛ
ئىچسىمۇ	it͡ʃsimu
ئىچكىرى	it͡ʃkiri
ئىچىدىن	it͡ʃidin
ئىچىشكە	it͡ʃiʃkɛ
ئىچىشىپ	it͡ʃiʃip
ئىچىمدە	it͡ʃimdɛ
ئىگىرىپ	iɡirip
ئىگىمىش	iɡimiʃ
ئۆتۈشكە	øtyʃkɛ
ئۆتۈشمە	øtyʃmɛ
ئۆتۈپتۇ	øtyptu
ئۆتەيدۇ	øtɛjdu
ئۆرىدەپ	øridɛp
ئۆرۈلۈپ	ørylyp
ئۆزئارا	øzara
ئۆزلىرى	øzliri
ئۆزىدىن	øzidin
ئۆزىمىز	øzimiz
ئۆزىنىڭ	øziniŋ
ئۆزىڭىز	øziŋiz
ئۆزگىچە	øzɡit͡ʃɛ
ئۆزۈملا	øzymla
ئۆزۈممۇ	øzymmu
ئۆزۈمنى	øzymni
ئۆسۈشكە	øsyʃkɛ
ئۆلۈپتۇ	ølyptu
ئۆلەيلى	ølɛjli
ئۆمىلەپ	ømilɛp
ئۆمۈچۈك	ømyt͡ʃyk
ئۆيدىكى	øjdiki
ئۆيۈمنى	øjymni
ئۆيۈمگە	øjymɡɛ
ئۆڭسۆلى	øŋsøli
ئۆگزىدە	øɡzidɛ
ئۆگزىگە	øɡziɡɛ
ئۆگىتىپ	øɡitip
ئۆگىنىش	øɡiniʃ
ئۆگىنەي	øɡinɛj
ئۆگەندى	øɡɛndi
ئۇدۇلغا	udulʁa
ئۇدۇللا	udulla
ئۇرۇلۇپ	urulup
ئۇزاققا	uzaqqa
ئۇزىتىپ	uzitip
ئۇزىراپ	uzirap
ئۇكاممۇ	ukammu
ئۇلاردا	ularda
ئۇلارغا	ularʁa
ئۇلارمۇ	ularmu
ئۇلارنى	ularni
ئۇلارنڭ	ularnŋ
ئۇلاپلا	ulapla
ئۇلىدىن	ulidin
ئۇنىماي	unimaj
ئۇنىڭدا	uniŋda
ئۇنىڭغا	uniŋʁa
ئۇنىڭكى	uniŋki
ئۇنىڭمۇ	uniŋmu
ئۇياققا	ujaqqa
ئۇيالدى	ujaldi
ئۇيقۇغا	ujquʁa
ئۇيۇشما	ujuʃma
ئۇچرىدى	ut͡ʃridi
ئۇچقۇچى	ut͡ʃqut͡ʃi
ئۇچۇرغا	ut͡ʃurʁa
ئۇچۇرۇپ	ut͡ʃurup
ئۇچۇشقا	ut͡ʃuʃqa
ئۇچۇپتۇ	ut͡ʃuptu
ئۇۋۇلاپ	uwulap
ئۈرۈمچى	yrymt͡ʃi
ئۈزۈمنى	yzymni
ئۈزەتتى	yzɛtti
ئۈزەڭگە	yzɛŋɡɛ
ئۈستىدە	ystidɛ
ئۈستىگە	ystiɡɛ
ئۈمىدنى	ymidni
ئۈن–تىن	yn–tin
ئۈچىنچى	yt͡ʃint͡ʃi
ئېتىبار	etibar
ئېتىراپ	etirap
ئېتىشقا	etiʃqa
ئېتىشنى	etiʃni
ئېتىلىپ	etilip
ئېتىپتۇ	etiptu
ئېرىتىپ	eritip
ئېرىدىن	eridin
ئېرىشتى	eriʃti
ئېرىشىش	eriʃiʃ
ئېرىنىڭ	eriniŋ
ئېرىگەن	eriɡɛn
ئېسىدىن	esidin
ئېسىلىپ	esilip
ئېسىمدە	esimdɛ
ئېسىمگە	esimɡɛ
ئېسىڭدە	esiŋdɛ
ئېسەدەپ	esɛdɛp
ئېقىتىپ	eqitip
ئېقىشقا	eqiʃqa
ئېلىشقا	eliʃqa
ئېلىشنى	eliʃni
ئېلىنسا	elinsa
ئېلېكتر	elektr
ئېيتىدۇ	ejtidu
ئېيتىڭا	ejtiŋa
ئېيىنىڭ	ejiniŋ
ئېچىشتى	et͡ʃiʃti
ئېچىشقا	et͡ʃiʃqa
ئېچىشكە	et͡ʃiʃkɛ
ئېچىلدى	et͡ʃildi
ئېچىلىپ	et͡ʃilip
ئېگىلىپ	eɡilip
ئەتراپى	ɛtrapi
ئەترىتى	ɛtriti
ئەتىياز	ɛtijaz
ئەتىگەن	ɛtiɡɛn
ئەجرىگە	ɛd͡ʒriɡɛ
ئەخلاقى	ɛχlaqi
ئەدەبىي	ɛdɛbij
ئەربابى	ɛrbabi
ئەرزىنى	ɛrzini
ئەرۋاھى	ɛrwahi
ئەزىمەت	ɛzimɛt
ئەسلىدە	ɛslidɛ
ئەسلىمە	ɛslimɛ
ئەسلىھە	ɛslihɛ
ئەكسىنى	ɛksini
ئەكسىچە	ɛksit͡ʃɛ
ئەكسىگە	ɛksiɡɛ
ئەكىرىپ	ɛkirip
ئەكىلىپ	ɛkilip
ئەكەلسە	ɛkɛlsɛ
ئەلىنىڭ	ɛliniŋ
ئەمدىلا	ɛmdila
ئەمەسمۇ	ɛmɛsmu
ئەمەلدە	ɛmɛldɛ
ئەمەلىي	ɛmɛlij
ئەمەلگە	ɛmɛlɡɛ
ئەندىشە	ɛndiʃɛ
ئەندۇۋا	ɛnduwa
ئەپەندى	ɛpɛndi
ئەگىشىپ	ɛɡiʃip
ئەۋەتتى	ɛwɛtti
ئەۋەتىپ	ɛwɛtip
باراتتى	baratti
باراڭغا	baraŋʁa
بارغىچە	barʁit͡ʃɛ
بارلىرى	barliri
بارمىدۇ	barmidu
بارمىقى	barmiqi
باسىسەن	basisɛn
باشقىچە	baʃqit͡ʃɛ
باشلىدى	baʃlidi
باشلىقى	baʃliqi
باغرىدا	baʁrida
باغرىغا	baʁriʁa
باغچىدا	baʁt͡ʃida
باغچىسى	baʁt͡ʃisi
باغچىغا	baʁt͡ʃiʁa
باقايلى	baqajli
باققىلى	baqqili
باقمىدى	baqmidi
باقىمىز	baqimiz
بالىدىن	balidin
بالىدۇر	balidur
بالىدەك	balidɛk
بالىلار	balilar
بالىلىق	baliliq
بالىنىڭ	baliniŋ
بالىڭىز	baliŋiz
باياتىن	bajatin
بايقىدى	bajqidi
باھاردا	baharda
باھارنى	baharni
بورانغا	boranʁa
بولاتتى	bolatti
بولارمۇ	bolarmu
بولامدۇ	bolamdu
بولدىلا	boldila
بولسىلا	bolsila
بولسىمۇ	bolsimu
بولغىنى	bolʁini
بولكىنى	bolkini
بولمىسا	bolmisa
بولىسەن	bolisɛn
بولىمىز	bolimiz
بولىمەن	bolimɛn
بولۇشتى	boluʃti
بولۇشسا	boluʃsa
بولۇشقا	boluʃqa
بولۇشنى	boluʃni
بولۇشۇم	boluʃum
بولۇشۇپ	boluʃup
بولۇقنى	boluqni
بولۇپتۇ	boluptu
بولۇپلا	bolupla
بوياققا	bojaqqa
بوينىنى	bojnini
بويىدىن	bojidin
بويىقىم	bojiqim
بوۋايغا	bowajʁa
بوۋاينى	bowajni
بىئارام	biaram
بىراقلا	biraqla
بىرسىگە	birsiɡɛ
بىرىدىن	biridin
بىرىنچى	birint͡ʃi
بىرەرسى	birɛrsi
بىزنىمۇ	biznimu
بىلسىدى	bilsidi
بىلمىسە	bilmisɛ
بىلوگدا	biloɡda
بىلوگنى	biloɡni
بىلىمدە	bilimdɛ
بىلىمىم	bilimim
بىلىمەن	bilimɛn
بىلىندى	bilindi
بىلىنىپ	bilinip
بىلىنەر	bilinɛr
بىلەتتى	bilɛtti
بىلەمدۇ	bilɛmdu
بىلەنلا	bilɛnla
بىنالار	binalar
بىنانىڭ	binaniŋ
بىپايان	bipajan
بىۋاستە	biwastɛ
بۆرىكەن	børikɛn
بۆرىلەر	børilɛr
بۆرىنىڭ	børiniŋ
بۆلۈشنى	bølyʃni
بۆلۈمنى	bølymni
بۆلەكچە	bølɛkt͡ʃɛ
بۇرۇلدى	buruldi
بۇرۇلسا	burulsa
بۇرۇلۇپ	burulup
بۇرۇنقى	burunqi
بۇزغىلى	buzʁili
بۇزۇلدى	buzuldi
بۇلارغا	bularʁa
بۇلارنى	bularni
بۇلۇتقا	bulutqa
بۇنىڭدا	buniŋda
بۇنىڭغا	buniŋʁa
بۇياققا	bujaqqa
بۈگۈنكى	byɡynki
بېتىمىز	betimiz
بېجىرىپ	bed͡ʒirip
بېرىشتى	beriʃti
بېرىشنى	beriʃni
بېرىلدى	berildi
بېرىلسە	berilsɛ
بېرىلىپ	berilip
بېرىمىز	berimiz
بېرىمەن	berimɛn
بېرىپتۇ	beriptu
بېرىۋال	beriwal
بېرەتتى	berɛtti
بېسىپتۇ	besiptu
بېشىدىن	beʃidin
بېشىڭدا	beʃiŋda
بېغىنىڭ	beʁiniŋ
بېقىشقا	beqiʃqa
بېقىپتۇ	beqiptu
بېقىڭچۇ	beqiŋt͡ʃu
بېكەتتە	bekɛttɛ
بېكەتكە	bekɛtkɛ
بېيىتىپ	bejitip
بېيىغان	bejiʁan
بېگىنىڭ	beɡiniŋ
بەدىئىي	bɛdiij
بەرسىلە	bɛrsilɛ
بەرمىدى	bɛrmidi
بەرمىسە	bɛrmisɛ
بەرىبىر	bɛribir
بەرگىنى	bɛrɡini
بەرگۈچى	bɛrɡyt͡ʃi
بەزىلەر	bɛzilɛr
بەستىگە	bɛstiɡɛ
بەشتالا	bɛʃtala
بەقەسەم	bɛqɛsɛm
بەللىرى	bɛlliri
بەھۇزۇر	bɛhuzur
تاتىرىپ	tatirip
تارايدۇ	tarajdu
تاراپتۇ	taraptu
تارتقان	tartqan
تارتماي	tartmaj
تارىخقا	tariχqa
تازىلىق	taziliq
تاشقىرى	taʃqiri
تاغلىرى	taʁliri
تاغىلار	taʁilar
تاقابىل	taqabil
تالىشىپ	taliʃip
تاماقنى	tamaqni
تامامەن	tamamɛn
تانىنىڭ	taniniŋ
تايىنىپ	tajinip
تاپقىلى	tapqili
تاپىلاپ	tapilap
توختىدى	toχtidi
توخۇنىڭ	toχuniŋ
تورىدەك	toridɛk
تورۇقنى	toruqni
توسۇلۇپ	tosulup
توغرىمۇ	toʁrimu
توقايدا	toqajda
توقۇلۇپ	toqulup
توكارېپ	tokarep
تولۇپتۇ	toluptu
توپلىمى	toplimi
توپىلىق	topiliq
توپ–توپ	top–top
توۋلىدى	towlidi
تىت–تىت	tit–tit
تىداننى	tidanni
تىرىشىش	tiriʃiʃ
تىرىشىڭ	tiriʃiŋ
تىرىلدى	tirildi
تىزمىسى	tizmisi
تىزىلدى	tizildi
تىقىلىپ	tiqilip
تىكىشكە	tikiʃkɛ
تىكىلدى	tikildi
تىكىلىپ	tikilip
تىكىپتۇ	tikiptu
تىلاۋەت	tilawɛt
تىللىدى	tillidi
تىلىدىن	tilidin
تۆتىنچى	tøtint͡ʃi
تۆرىدىن	tøridin
تۆشۈكچە	tøʃykt͡ʃɛ
تۆكۈلۈپ	tøkylyp
تۆگىنىڭ	tøɡiniŋ
تۆگەمنى	tøɡɛmni
تۆۋەندە	tøwɛndɛ
تۆۋەنگە	tøwɛnɡɛ
تۇتاتتى	tutatti
تۇتقىلى	tutqili
تۇتىشىپ	tutiʃip
تۇتۇشتى	tutuʃti
تۇتۇشنى	tutuʃni
تۇتۇندى	tutundi
تۇخۇمنى	tuχumni
تۇراتتى	turatti
تۇرسىمۇ	tursimu
تۇرغىنى	turʁini
تۇرقىدا	turqida
تۇرقىنى	turqini
تۇرمۇشى	turmuʃi
تۇرىمىز	turimiz
تۇرۇشقا	turuʃqa
تۇرۇشۇپ	turuʃup
تۇرۇپتۇ	turuptu
تۇرۇپلا	turupla
تۇرۇپمۇ	turupmu
تۇيغۇسى	tujʁusi
تۇيغۇغا	tujʁuʁa
تۇيغۇنى	tujʁuni
تۇيۇلدى	tujuldi
تۇڭىدىن	tuŋidin
تۈزۈلمە	tyzylmɛ
تۈنبويى	tynboji
تۈنۈگۈن	tynyɡyn
تۈپەيلى	typɛjli
تۈگىگەن	tyɡiɡɛn
تېخنىكا	teχnika
تېرىكىپ	terikip
تېرىلغۇ	terilʁu
تېرىپتۇ	teriptu
تېز–تېز	tez–tez
تېشىلىپ	teʃilip
تېگىدىن	teɡidin
تېگەتتى	teɡɛtti
تەبىئىي	tɛbiij
تەبىئەت	tɛbiɛt
تەجرىبە	tɛd͡ʒribɛ
تەربىيە	tɛrbijɛ
تەركىبى	tɛrkibi
تەرپىدە	tɛrpidɛ
تەرگىلى	tɛrɡili
تەرەپتە	tɛrɛptɛ
تەرەپكە	tɛrɛpkɛ
تەرەپنى	tɛrɛpni
تەسەللى	tɛsɛlli
تەشكىلى	tɛʃkili
تەكتىنى	tɛktini
تەكتىگە	tɛktiɡɛ
تەڭدىشى	tɛŋdiʃi
جاسارەت	d͡ʒasarɛt
جامائەت	d͡ʒamaɛt
جاپالىق	d͡ʒapaliq
جاپانىڭ	d͡ʒapaniŋ
جاھانمۇ	d͡ʒahanmu
جۇڭگودا	d͡ʒuŋɡoda
جېكىلدى	d͡ʒekildi
جېنىدىن	d͡ʒenidin
جەريانى	d͡ʒɛrjani
جەنۇبقا	d͡ʒɛnubqa
جەينىكى	d͡ʒɛjniki
جەھەتتە	d͡ʒɛhɛttɛ
خاتالىق	χataliq
خاترجەم	χatrd͡ʒɛm
خالايدۇ	χalajdu
خالايىق	χalajiq
خالىغان	χaliʁan
خاماندا	χamanda
خامانغا	χamanʁa
خانىمغا	χanimʁa
خوتۇنغا	χotunʁa
خوجايىن	χod͡ʒajin
خىرىسقا	χirisqa
خىرىسنى	χirisni
خىزمىتى	χizmiti
خىللىرى	χilliri
خىيالىي	χijalij
خۇدايىم	χudajim
خېرىدار	χeridar
خەتلىرى	χɛtliri
خەلقنىڭ	χɛlqniŋ
خەۋەرنى	χɛwɛrni
دائىرسى	dairsi
دادامغا	dadamʁa
داداممۇ	dadammu
دادامنى	dadamni
دادا–ھە	dada–hɛ
دادىمغا	dadimʁa
دارىگەي	dariɡɛj
داھىيغا	dahijʁa
داۋانغا	dawanʁa
دوستلار	dostlar
دوغچىغا	doʁt͡ʃiʁa
دوكىلات	dokilat
دوپپىسى	doppisi
دوپپىغا	doppiʁa
دوپپىنى	doppini
دىتىنىڭ	ditiniŋ
دىققىتى	diqqiti
دىكتورى	diktori
دىككىدە	dikkidɛ
دىلىغۇل	diliʁul
دىماغقا	dimaʁqa
دىيىشىپ	dijiʃip
دۆلەتتە	dølɛttɛ
دۆلەتكە	dølɛtkɛ
دۆلەتنى	dølɛtni
دۆۋىلەپ	døwilɛp
دۇنيادا	dunjada
دۇنياسى	dunjasi
دۇنيانى	dunjani
دۇنيانڭ	dunjanŋ
دۇنياۋى	dunjawi
دېتىشتى	detiʃti
دېدىڭىز	dediŋiz
دېدۇقكى	deduqki
دېمەككە	demɛkkɛ
دېيىشنى	dejiʃni
دېيىشىپ	dejiʃip
دېپلومى	deplomi
دېڭىزغا	deŋizʁa
دېگىنىڭ	deɡiniŋ
دېگۈدەك	deɡydɛk
دېگەندە	deɡɛndɛ
دېگەننى	deɡɛnni
دېۋىتتى	dewitti
دېۋىدىم	dewidim
دەرخلەر	dɛrχlɛr
دەردىنى	dɛrdini
دەرياسى	dɛrjasi
دەرياغا	dɛrjaʁa
دەريانى	dɛrjani
دەرۋەقە	dɛrwɛqɛ
دەرەخنى	dɛrɛχni
دەۋرىدە	dɛwridɛ
رادىينى	radijni
رايوننى	rajonni
روياپقا	rojapqa
رىتىمدا	ritimda
رەتتىكى	rɛttiki
رەختتىن	rɛχttin
رەختنىڭ	rɛχtniŋ
رەختىنى	rɛχtini
رەڭگىچۇ	rɛŋɡit͡ʃu
رەھبىرى	rɛhbiri
رەۋىشتە	rɛwiʃtɛ
زاماندا	zamanda
زىيارەت	zijarɛt
زېرىكتى	zerikti
زېمىننى	zeminni
زېھنىنى	zehnini
زەربىگە	zɛrbiɡɛ
سائەتتە	saɛttɛ
سائەتچە	saɛtt͡ʃɛ
ساتىراش	satiraʃ
ساتىسەن	satisɛn
ساتىمەن	satimɛn
ساداقەت	sadaqɛt
سادىققا	sadiqqa
سادىقنى	sadiqni
سازاۋەر	sazawɛr
ساشانىڭ	saʃaniŋ
سانائەت	sanaɛt
ساناشقا	sanaʃqa
ساندىكى	sandiki
ساياھەت	sajahɛt
سايىۋەن	sajiwɛn
سوئالغا	soalʁa
سوئالنى	soalni
سودىمىز	sodimiz
سودىگەر	sodiɡɛr
سورايدۇ	sorajdu
سوراپتۇ	soraptu
سورتلۇق	sortluq
سورىدىم	soridim
سورىسام	sorisam
سورىشىڭ	soriʃiŋ
سورىغان	soriʁan
سورۇنغا	sorunʁa
سوزۇلۇپ	sozulup
سوغۇقتا	soʁuqta
سوغۇققا	soʁuqqa
سوقۇلۇپ	soqulup
سولىشىپ	soliʃip
سومكىدن	somkidn
سوۋغىتى	sowʁiti
سىرتىدا	sirtida
سىرلىرى	sirliri
سىرىتتا	siritta
سىلسىيە	silsijɛ
سىلىدىن	silidin
سىلىنىڭ	siliniŋ
سىلەرنى	silɛrni
سىلەرگە	silɛrɡɛ
سىمۋولى	simwoli
سىنىپتا	sinipta
سىنىپقا	sinipqa
سىيەككە	sijɛkkɛ
سۆرەتكە	sørɛtkɛ
سۆزلىدى	søzlidi
سۆزلىرى	søzliri
سۆزىدىن	søzidin
سۆزۈمگە	søzymɡɛ
سۆكۈلۈپ	søkylyp
سۆيىمىز	søjimiz
سۆيىمەن	søjimɛn
سۆيۈنۈش	søjynyʃ
سۆيۈنۈپ	søjynyp
سۆيەتتى	søjɛtti
سۇئالنى	sualni
سۇغىرىپ	suʁirip
سۇچىلىق	sut͡ʃiliq
سۈرئىتى	syriti
سۈرمىدى	syrmidi
سۈرەتتى	syrɛtti
سۈرەتكە	syrɛtkɛ
سۈزۈككى	syzykki
سۈكۈتكە	sykytkɛ
سۈمۈرۈش	symyryʃ
سۈيىنىڭ	syjiniŋ
سۈپىتىم	sypitim
سۈپۈرۈپ	sypyryp
سېريوشا	serjoʃa
سېزىمگە	sezimɡɛ
سېلىشقا	seliʃqa
سېلىشىپ	seliʃip
سېلىنچا	selint͡ʃa
سېۋەتتە	sewɛttɛ
سېۋەتنى	sewɛtni
سەزگۈسى	sɛzɡysi
سەمىرىپ	sɛmirip
سەمىمىي	sɛmimij
سەنئىتى	sɛniti
سەندىكى	sɛndiki
سەندىمۇ	sɛndimu
سەن–پەن	sɛn–pɛn
سەيلىسى	sɛjlisi
سەگىدەپ	sɛɡidɛp
سەھرادا	sɛhrada
سەھەردە	sɛhɛrdɛ
شاختىكى	ʃaχtiki
شاخلىرى	ʃaχliri
شادىمان	ʃadiman
شارىدىن	ʃaridin
شارىمىز	ʃarimiz
شارىنىڭ	ʃariniŋ
شاكىچىك	ʃakit͡ʃik
شامالدا	ʃamalda
شامالغا	ʃamalʁa
شاپپىدە	ʃappidɛ
شاۋقۇنى	ʃawquni
شورىغۇچ	ʃoriʁut͡ʃ
شىرنىسى	ʃirnisi
شىرەنىڭ	ʃirɛniŋ
شىمالغا	ʃimalʁa
شىمالىي	ʃimalij
شىملىرى	ʃimliri
شىپالىق	ʃipaliq
شىپىرىس	ʃipiris
شۇقەدەر	ʃuqɛdɛr
شۇلارنى	ʃularni
شۇنىڭغا	ʃuniŋʁa
شۇھامان	ʃuhaman
شېئىرنى	ʃeirni
شەرتلىك	ʃɛrtlik
شەرتىنى	ʃɛrtini
شەرقىگە	ʃɛrqiɡɛ
شەكلىدە	ʃɛklidɛ
شەكىلنى	ʃɛkilni
شەكىلگە	ʃɛkilɡɛ
شەيئىنى	ʃɛjini
شەھەردە	ʃɛhɛrdɛ
شەھەرگە	ʃɛhɛrɡɛ
غوجاكاڭ	ʁod͡ʒakaŋ
غوجىدار	ʁod͡ʒidar
غۇلجىغا	ʁuld͡ʒiʁa
غۇلغۇلا	ʁulʁula
غۇچچىدە	ʁut͡ʃt͡ʃidɛ
غۇژژىدە	ʁuʒʒidɛ
فىلمىنى	filmini
قاتلىمى	qatlimi
قاراشتى	qaraʃti
قاراپتۇ	qaraptu
قاراپلا	qarapla
قاراڭغۇ	qaraŋʁu
قارىتىپ	qaritip
قارىداپ	qaridap
قارىدىم	qaridim
قارىسام	qarisam
قارىشىپ	qariʃip
قارىغان	qariʁan
قارىغاي	qariʁaj
قارىماي	qarimaj
قارىيىپ	qarijip
قازىبەگ	qazibɛɡ
قاشلىدى	qaʃlidi
قاشلىرى	qaʃliri
قالاتتى	qalatti
قالايلا	qalajla
قالايلى	qalajli
قالمىدى	qalmidi
قالىمەن	qalimɛn
قانائەت	qanaɛt
قاناسنى	qanasni
قاياققا	qajaqqa
قايتقان	qajtqan
قايرىما	qajrima
قاينىمى	qajnimi
قاپتىغۇ	qaptiʁu
قاپقارا	qapqara
قاپلىدى	qaplidi
قاچىلاپ	qat͡ʃilap
قورققان	qorqqan
قورقىدۇ	qorqidu
قورقۇنچ	qorqunt͡ʃ
قورۇنۇپ	qorunup
قورۇپتۇ	qoruptu
قوزغىدى	qozʁidi
قوزىنىڭ	qoziniŋ
قوشاقچى	qoʃaqt͡ʃi
قوشۇلۇپ	qoʃulup
قوشۇمچە	qoʃumt͡ʃɛ
قوشۇپتۇ	qoʃuptu
قوغدىشى	qoʁdiʃi
قوغۇشۇن	qoʁuʃun
قوللىرى	qolliri
قولىدىن	qolidin
قولۇمغا	qolumʁa
قونۇپتۇ	qonuptu
قوياتتى	qojatti
قويايلى	qojajli
قويايمۇ	qojajmu
قويدىيۇ	qojdiju
قويسىمۇ	qojsimu
قويغىلا	qojʁila
قويمىدى	qojmidi
قوينىغا	qojniʁa
قويىمىز	qojimiz
قويۇشتى	qojuʃti
قويۇشنى	qojuʃni
قويۇپتۇ	qojuptu
قىزلىرى	qizliri
قىزىرىپ	qizirip
قىزىقىپ	qiziqip
قىزىمنى	qizimni
قىزىنىڭ	qiziniŋ
قىستىشى	qistiʃi
قىسقىسى	qisqisi
قىسىلىپ	qisilip
قىلاتتى	qilatti
قىلارمۇ	qilarmu
قىلايلى	qilajli
قىلايچۇ	qilajt͡ʃu
قىلسىلا	qilsila
قىلسىمۇ	qilsimu
قىلغىلى	qilʁili
قىلغىنى	qilʁini
قىلغۇچى	qilʁut͡ʃi
قىلمىدى	qilmidi
قىلمىسا	qilmisa
قىلىسەن	qilisɛn
قىلىشتا	qiliʃta
قىلىشتى	qiliʃti
قىلىشقا	qiliʃqa
قىلىشنى	qiliʃni
قىلىشىم	qiliʃim
قىلىشىپ	qiliʃip
قىلىمىز	qilimiz
قىلىمەن	qilimɛn
قىلىندى	qilindi
قىلىندۇ	qilindu
قىلىنىپ	qilinip
قىلىپتۇ	qiliptu
قىلىپلا	qilipla
قىلىپمۇ	qilipmu
قىممىتى	qimmiti
قۇدرىتى	qudriti
قۇرۇتنى	qurutni
قۇرۇسۇن	qurusun
قۇرۇشقا	quruʃqa
قۇرۇلۇش	quruluʃ
قۇشقىچى	quʃqit͡ʃi
قۇلاققا	qulaqqa
قۇياشقا	qujaʃqa
قۇياشنى	qujaʃni
قۇيرۇقى	qujruqi
قۇيۇلدى	qujuldi
قۇچىقىڭ	qut͡ʃiqiŋ
قېتىشىپ	qetiʃip
قېتىقتا	qetiqta
قېتىمدا	qetimda
قېتىمقى	qetimqi
قېشىدىن	qeʃidin
قېلىشتى	qeliʃti
قېلىشقا	qeliʃqa
قېپىدىن	qepidin
قېپىنىڭ	qepiniŋ
قەدرىگە	qɛdriɡɛ
قەدىمكى	qɛdimki
قەدىمىي	qɛdimij
قەدەمدە	qɛdɛmdɛ
قەدەمچە	qɛdɛmt͡ʃɛ
قەرزدار	qɛrzdar
قەرەلدە	qɛrɛldɛ
قەغەزنى	qɛʁɛzni
قەلىمىم	qɛlimim
قەلەمنى	qɛlɛmni
قەيەردە	qɛjɛrdɛ
كاتېرغا	katerʁa
كارىزنى	karizni
كاللىسى	kallisi
كاۋىدىن	kawidin
كاۋىلار	kawilar
كراينىڭ	krajniŋ
كولاشقا	kolaʃqa
كونترول	kontrol
كونىراپ	konirap
كىتابقا	kitabqa
كىتابنى	kitabni
كىتىشتى	kitiʃti
كىتەتتى	kitɛtti
كىرمىدى	kirmidi
كىرىشتى	kiriʃti
كىرىشكە	kiriʃkɛ
كىرىشىپ	kiriʃip
كىرىمەن	kirimɛn
كىرىپلا	kiripla
كىرپىكى	kirpiki
كىرپىنى	kirpini
كىرگىلى	kirɡili
كىرگۈچە	kirɡyt͡ʃɛ
كىسىشكە	kisiʃkɛ
كىشىدىن	kiʃidin
كىشىدەك	kiʃidɛk
كىشىلەر	kiʃilɛr
كىشىنىڭ	kiʃiniŋ
كىنگورۇ	kinɡoru
كىيمىنى	kijmini
كىيىممۇ	kijimmu
كىيىمنى	kijimni
كىيىمىم	kijimim
كىيىمگە	kijimɡɛ
كىيىنكى	kijinki
كىيىنىش	kijiniʃ
كىيىنىپ	kijinip
كىيىۋال	kijiwal
كۆتۈردى	køtyrdi
كۆتۈرۈپ	køtyryp
كۆرسىلە	kørsilɛ
كۆرىكەن	kørikɛn
كۆرىمەن	kørimɛn
كۆرگىلى	kørɡili
كۆرگىنى	kørɡini
كۆرۈشكە	køryʃkɛ
كۆرۈشنى	køryʃni
كۆرۈشۈم	køryʃym
كۆرۈندى	køryndi
كۆرۈنۈپ	kørynyp
كۆرۈپتۇ	køryptu
كۆرۈپلا	kørypla
كۆرەتتى	kørɛtti
كۆزلىرى	køzliri
كۆزىتىپ	køzitip
كۆزىنىڭ	køziniŋ
كۆزىڭىز	køziŋiz
كۆزۈمنى	køzymni
كۆزۈمگە	køzymɡɛ
كۆزۈڭنى	køzyŋni
كۆلبېگى	kølbeɡi
كۆلدىكى	køldiki
كۆلىنىڭ	køliniŋ
كۆمۈلۈپ	kømylyp
كۆپرەكى	køprɛki
كۆپىنچە	køpint͡ʃɛ
كۆپىيىپ	køpijip
كۆپەيسە	køpɛjsɛ
كۆچۈرۈش	køt͡ʃyryʃ
كۆچۈرۈپ	køt͡ʃyryp
كۆڭلىدە	køŋlidɛ
كۆڭلىنى	køŋlini
كۆڭلىگە	køŋliɡɛ
كۇرسىنى	kursini
كۈتكۈچى	kytkyt͡ʃi
كۈرۈشكە	kyryʃkɛ
كۈلكىسى	kylkisi
كۈلىسەن	kylisɛn
كۈلۈشۈپ	kylyʃyp
كۈلۈپتۇ	kylyptu
كۈلۈپلا	kylypla
كۈلەيلى	kylɛjli
كۈندۈزى	kyndyzi
كۈنسېرى	kynseri
كۈنلىرى	kynliri
كۈنۈمنى	kynymni
كۈچىدىن	kyt͡ʃidin
كۈچۈكنى	kyt͡ʃykni
كۈچۈمنى	kyt͡ʃymni
كۈچەشكە	kyt͡ʃɛʃkɛ
كېتىشتى	ketiʃti
كېتىمەن	ketimɛn
كېتىپتۇ	ketiptu
كېتەتتى	ketɛtti
كېرەسىز	kerɛsiz
كېسەلگە	kesɛlɡɛ
كېلىشتى	keliʃti
كېلىشتە	keliʃtɛ
كېلىشكە	keliʃkɛ
كېلىشنى	keliʃni
كېلىشىپ	keliʃip
كېلىپلا	kelipla
كېلەتتى	kelɛtti
كېلەمدۇ	kelɛmdu
كېيىنكى	kejinki
كېيىنلا	kejinla
كېپىنەك	kepinɛk
كېچىكىپ	ket͡ʃikip
كېچىلىك	ket͡ʃilik
كېچىلەپ	ket͡ʃilɛp
كېچىپتۇ	ket͡ʃiptu
كەتتىغۇ	kɛttiʁu
كەتسىمۇ	kɛtsimu
كەتمىدى	kɛtmidi
كەسىپكە	kɛsipkɛ
كەسپىنى	kɛspini
كەسپىگە	kɛspiɡɛ
كەلسىلە	kɛlsilɛ
كەلمىدى	kɛlmidi
كەلمىسە	kɛlmisɛ
كەلگۈسى	kɛlɡysi
كەلگۈچى	kɛlɡyt͡ʃi
كەنتتىن	kɛnttin
كەينىگە	kɛjniɡɛ
كەچكىچە	kɛt͡ʃkit͡ʃɛ
كەچۈرۈپ	kɛt͡ʃyryp
كەچۈرۈڭ	kɛt͡ʃyryŋ
كەڭلىكى	kɛŋliki
لازىمكى	lazimki
لاپپىدە	lappidɛ
لاۋزىمۇ	lawzimu
لونزۋېن	lonzwen
لوياڭغا	lojaŋʁa
لوڭقىسى	loŋqisi
لىباسنى	libasni
لىرىمىز	lirimiz
لىققىدە	liqqidɛ
لىككىدە	likkidɛ
لۆڭگىنى	løŋɡini
لېنتىغا	lentiʁa
لېنىنغا	leninʁa
لېنىنمۇ	leninmu
لېۋىمنى	lewimni
لەپپىدە	lɛppidɛ
لەۋزىدە	lɛwzidɛ
لەۋلىرى	lɛwliri
مائارىپ	maarip
ماتورغا	matorʁa
ماركىسى	markisi
ماڭىسەن	maŋisɛn
ماڭىمەن	maŋimɛn
ماھارەت	maharɛt
موللىقى	molliqi
مىسرانى	misrani
مىسلىقى	misliqi
مىلىنىپ	milinip
مىليارد	miljard
مىنۇتقا	minutqa
مىنېرال	mineral
مىيقىدا	mijqida
مىڭبېگى	miŋbeɡi
مۇئاۋىن	muawin
مۇخبىرى	muχbiri
مۇددىتى	mudditi
مۇراتقا	muratqa
مۇراسىم	murasim
مۇرەسسە	murɛssɛ
مۇكاپات	mukapat
مۇلايىم	mulajim
مۇنۇلار	munular
مۇھىتنى	muhitni
مۇۋاپىق	muwapiq
مۈرەمگە	myrɛmɡɛ
مېنىڭلا	meniŋla
مېنىڭمۇ	meniŋmu
مېنېرال	meneral
مېڭىشقا	meŋiʃqa
مېڭىپتۇ	meŋiptu
مېۋىلىك	mewilik
مېۋىلەر	mewilɛr
مەجبۇرى	mɛd͡ʒburi
مەدەنىي	mɛdɛnij
مەركىزى	mɛrkizi
مەزمۇنى	mɛzmuni
مەزگىلى	mɛzɡili
مەسئۇلى	mɛsuli
مەشرىپى	mɛʃripi
مەكتىپى	mɛktipi
مەنبەسى	mɛnbɛsi
مەندىكى	mɛndiki
مەنزىرە	mɛnzirɛ
مەنىلىك	mɛnilik
مەيدانى	mɛjdani
مەڭزىگە	mɛŋziɡɛ
مەھسۇلى	mɛhsuli
مەھلىيا	mɛhlija
مەھەللە	mɛhɛllɛ
نازارەت	nazarɛt
نازاكەت	nazakɛt
نامايان	namajan
نامايىش	namajiʃ
نامايەن	namajɛn
نامەلۇم	namɛlum
ناھايتى	nahajti
نوپۇزغا	nopuzʁa
نىسبىتى	nisbiti
نىشانغا	niʃanʁa
نىمىشقا	nimiʃqa
نىيتىگە	nijtiɡɛ
نۆۋەتتە	nøwɛttɛ
نۇرىنىڭ	nuriniŋ
نۇقتىغا	nuqtiʁa
نۇقتىنى	nuqtini
نېمانچە	nemant͡ʃɛ
نېمىدەپ	nemidɛp
نېمىشقا	nemiʃqa
نېمىلەر	nemilɛr
نېمىنىڭ	neminiŋ
نېگاتىپ	neɡatip
نەرسىدۇ	nɛrsidu
نەرسىنى	nɛrsini
نەزەرگە	nɛzɛrɡɛ
نەغمىسى	nɛʁmisi
نەقەدەر	nɛqɛdɛr
نەلەردە	nɛlɛrdɛ
نەيچىسى	nɛjt͡ʃisi
نەچچىسى	nɛt͡ʃt͡ʃisi
ياتاتتى	jatatti
ياتاققا	jataqqa
ياتىسەن	jatisɛn
ياخشىسى	jaχʃisi
ياخشىغا	jaχʃiʁa
يادنامە	jadnamɛ
يادىكار	jadikar
يادىمغا	jadimʁa
ياراشتى	jaraʃti
يارىتىپ	jaritip
يارىغان	jariʁan
ياساشنى	jasaʃni
ياسىتىپ	jasitip
ياسىغان	jasiʁan
ياشاشقا	jaʃaʃqa
ياشاشنى	jaʃaʃni
ياشايدۇ	jaʃajdu
ياشقىنا	jaʃqina
ياشلىرى	jaʃliri
ياشىنىپ	jaʃinip
ياغاتتى	jaʁatti
ياغاچنى	jaʁat͡ʃni
ياغاچچى	jaʁat͡ʃt͡ʃi
ياقمىدى	jaqmidi
ياقىلاپ	jaqilap
يالىڭاچ	jaliŋat͡ʃ
ياماشسا	jamaʃsa
يامانغا	jamanʁa
يامغۇرى	jamʁuri
يامىشىپ	jamiʃip
يانىسەن	janisɛn
يانىمەن	janimɛn
يوسۇندا	josunda
يوشۇرۇپ	joʃurup
يوغىناپ	joʁinap
يوقمىدى	joqmidi
يوقىتىپ	joqitip
يوقىلىپ	joqilip
يوللىرى	jolliri
يولىدۇر	jolidur
يولىنىڭ	joliniŋ
يولۇقتى	joluqti
يولۇقۇپ	joluqup
يوپۇرغا	jopurʁa
يىراقتا	jiraqta
يىراققا	jiraqqa
يىغلىدى	jiʁlidi
يىغىدىن	jiʁidin
يىغىشقا	jiʁiʃqa
يىقىلىپ	jiqilip
يىقىنلا	jiqinla
يىنىدىن	jinidin
يىڭىدىن	jiŋidin
يىگىتكە	jiɡitkɛ
يىگىتنى	jiɡitni
يىگىرمە	jiɡirmɛ
يۆتىلىپ	jøtilip
يۆلىنىپ	jølinip
يۆلەشكە	jølɛʃkɛ
يۆگىشىپ	jøɡiʃip
يۇرتىغا	jurtiʁa
يۇشۇرۇپ	juʃurup
يۇنۇشقا	junuʃqa
يۇيۇنۇش	jujunuʃ
يۈرسىمۇ	jyrsimu
يۈرگىلى	jyrɡili
يۈرۈپتۇ	jyryptu
يۈرەتتى	jyrɛtti
يۈرەكنى	jyrɛkni
يۈزىدىن	jyzidin
يۈزىنىڭ	jyziniŋ
يۈزۈمگە	jyzymɡɛ
يۈكۈنۈپ	jykynyp
يۈگۈردى	jyɡyrdi
يۈگۈرۈش	jyɡyryʃ
يۈگۈرۈپ	jyɡyryp
يۈەندىن	jyɛndin
يۈەنلىك	jyɛnlik
يېتىشىپ	jetiʃip
يېتىلەپ	jetilɛp
يېتىپتۇ	jetiptu
يېتىپمۇ	jetipmu
يېرىدىن	jeridin
يېزىدىن	jezidin
يېزىشقا	jeziʃqa
يېزىشنى	jeziʃni
يېزىلىق	jeziliq
يېزىنىڭ	jeziniŋ
يېشىلدى	jeʃildi
يېشىپتۇ	jeʃiptu
يېغىلىپ	jeʁilip
يېقىلغۇ	jeqilʁu
يېقىندا	jeqinda
يېقىنقى	jeqinqi
يېمىگىن	jemiɡin
يېنىدىن	jenidin
يېنىمدا	jenimda
يېنىمغا	jenimʁa
يېيىشكە	jejiʃkɛ
يېيىشنى	jejiʃni
يېيىلىپ	jejilip
يېپىنچا	jepint͡ʃa
يېڭىدىن	jeŋidin
يېڭىلاپ	jeŋilap
يېڭىلىپ	jeŋilip
يېگۈدەك	jeɡydɛk
يەتكىلى	jɛtkili
يەتكۈچە	jɛtkyt͡ʃɛ
يەردىكى	jɛrdiki
يەسلىگە	jɛsliɡɛ
يەشسىلە	jɛʃsilɛ
يەلپۈدى	jɛlpydi
پاتۇرۇپ	paturup
پاتېنىت	patenit
پادىشاھ	padiʃah
پاراخوت	paraχot
پاراخۇت	paraχut
پاراڭغا	paraŋʁa
پاراۋان	parawan
پارتكوم	partkom
پارتىيە	partijɛ
پاقىلار	paqilar
پاكىتتە	pakittɛ
پاللىدە	pallidɛ
پايدىغا	pajdiʁa
پوستىغا	postiʁa
پوستىنى	postini
پولشادا	polʃada
پىئونىر	pionir
پىرسەنت	pirsɛnt
پىرەنىك	pirɛnik
پىشىپتۇ	piʃiptu
پىشۇرۇپ	piʃurup
پىكىردە	pikirdɛ
پىچاققا	pit͡ʃaqqa
پىچاقنى	pit͡ʃaqni
پۇتلىرى	putliri
پۇتىدىن	putidin
پۇرىقىڭ	puriqiŋ
پۇلىنىڭ	puliniŋ
پۇلۇمنى	pulumni
پۈتۈشتى	pytyʃti
پۈۋلىدى	pywlidi
پېتېرغا	peterʁa
پېرېۋوت	perewot
پەردىسى	pɛrdisi
پەرزەنت	pɛrzɛnt
پەرقىگە	pɛrqiɡɛ
پەرىشان	pɛriʃan
پەرىشتە	pɛriʃtɛ
پەرۋامۇ	pɛrwamu
پەزىلەت	pɛzilɛt
پەسلىدە	pɛslidɛ
پەندىكى	pɛndiki
پەيتىدە	pɛjtidɛ
پەيلىرى	pɛjliri
چاغدىكى	t͡ʃaʁdiki
چاغدىلا	t͡ʃaʁdila
چاققىچە	t͡ʃaqqit͡ʃɛ
چاقىردى	t͡ʃaqirdi
چاقىرىق	t͡ʃaqiriq
چاقىرىم	t͡ʃaqirim
چاقىرىپ	t͡ʃaqirip
چالاتتى	t͡ʃalatti
چاپانغا	t͡ʃapanʁa
چاپاننى	t͡ʃapanni
چاچلىرى	t͡ʃat͡ʃliri
چاڭجياڭ	t͡ʃaŋd͡ʒjaŋ
چوكانغا	t͡ʃokanʁa
چىدامدۇ	t͡ʃidamdu
چىدىماي	t͡ʃidimaj
چىشلىرى	t͡ʃiʃliri
چىقاتتى	t͡ʃiqatti
چىقاردى	t͡ʃiqardi
چىققىلى	t͡ʃiqqili
چىققىنى	t͡ʃiqqini
چىقمىدى	t͡ʃiqmidi
چىقىرىپ	t͡ʃiqirip
چىقىشتا	t͡ʃiqiʃta
چىقىشتى	t͡ʃiqiʃti
چىقىشسا	t͡ʃiqiʃsa
چىقىشقا	t͡ʃiqiʃqa
چىقىلدى	t͡ʃiqildi
چىقىپتۇ	t͡ʃiqiptu
چىقىپلا	t͡ʃiqipla
چىككىنى	t͡ʃikkini
چىمپيون	t͡ʃimpjon
چىيانىڭ	t͡ʃijaniŋ
چىگرىسى	t͡ʃiɡrisi
چۆرىدەپ	t͡ʃøridɛp
چۆكۈرۈپ	t͡ʃøkyryp
چۆكۈشكە	t͡ʃøkyʃkɛ
چۆمىسىز	t͡ʃømisiz
چۆچەكنى	t͡ʃøt͡ʃɛkni
چۈشمىدى	t͡ʃyʃmidi
چۈشىمەن	t͡ʃyʃimɛn
چۈشىنىپ	t͡ʃyʃinip
چۈشۈردى	t͡ʃyʃyrdi
چۈشۈپتۇ	t͡ʃyʃyptu
چۈشەتتى	t͡ʃyʃɛtti
چۈمكىدى	t͡ʃymkidi
چېغىمدا	t͡ʃeʁimda
چېلىندى	t͡ʃelindi
چېلەكتە	t͡ʃelɛktɛ
چېنىقىش	t͡ʃeniqiʃ
چېپىلدۇ	t͡ʃepildu
چېچىلىپ	t͡ʃet͡ʃilip
چېچەككە	t͡ʃet͡ʃɛkkɛ
چېچەكنى	t͡ʃet͡ʃɛkni
گالىلېي	ɡalilej
گىرادۇس	ɡiradus
گىياھمۇ	ɡijahmu
گۆشۈمنى	ɡøʃymni
گۈللىرى	ɡylliri
گېزىتنى	ɡezitni
گەپ–سۆز	ɡɛp–søz
ھارارەت	hararɛt
ھارۋىسى	harwisi
ھازادىن	hazadin
ھازىرقى	hazirqi
ھازىرلا	hazirla
ھازىرمۇ	hazirmu
ھازىرچە	hazirt͡ʃɛ
ھاشارەت	haʃarɛt
ھالىدىن	halidin
ھالىمغا	halimʁa
ھالەتتە	halɛttɛ
ھاياجان	hajad͡ʒan
ھايالىق	hajaliq
ھاۋارەڭ	hawarɛŋ
ھاۋانىڭ	hawaniŋ
ھوقۇقنى	hoquqni
ھويلىغا	hojliʁa
ھىسابقا	hisabqa
ھىچنىمە	hit͡ʃnimɛ
ھۆسنىگە	høsniɡɛ
ھۆكۈمەت	høkymɛt
ھۆپپىدە	høppidɛ
ھۈسەيىن	hysɛjin
ھۈپپىدە	hyppidɛ
ھېسابات	hesabat
ھېسابتا	hesabta
ھېسابقا	hesabqa
ھېلىھەم	helihɛm
ھېچنىمە	het͡ʃnimɛ
ھېچنېمە	het͡ʃnemɛ
ھەجەپمۇ	hɛd͡ʒɛpmu
ھەدەمگە	hɛdɛmɡɛ
ھەركىتى	hɛrkiti
ھەرىدەپ	hɛridɛp
ھەرىكەت	hɛrikɛt
ھەققىدە	hɛqqidɛ
ھەققىنى	hɛqqini
ھەقىقىي	hɛqiqij
ھەقىقەت	hɛqiqɛt
ھەقىچان	hɛqit͡ʃan
ھەممىسى	hɛmmisi
ھەممىلا	hɛmmila
ھەممىنى	hɛmmini
ھەممىگە	hɛmmiɡɛ
ھەيئىتى	hɛjiti
ھەپتىدە	hɛptidɛ
ھەپتىسى	hɛptisi
ۋاقتىمۇ	waqtimu
ۋاقىتتا	waqitta
ۋاقىتقا	waqitqa
ۋاقىتنى	waqitni
ۋىلايەت	wilajɛt
ۋۇجۇدقا	wud͡ʒudqa
ۋۇجۇدۇم	wud͡ʒudum
ۋېتكانى	wetkani
ۋەجىدىن	wɛd͡ʒidin
ۋەزىرگە	wɛzirɡɛ
ۋەزىيەت	wɛzijɛt
–لەيلەپ	–lɛjlɛp
توقلىشى»غا	toqliʃi»ʁa
كىشنىدى-دە	kiʃnidi-dɛ
ئاجايىپ-غارايىپ	ad͡ʒajip-ʁarajip
ئۈزۈلۈپ-ئۈزۈلۈپ	yzylyp-yzylyp
ئىستىپا_بېرىش	istipa_beriʃ
ئېتىراپ_قىلدى	etirap_qildi
تېلېفون_قىلىپ	telefon_qilip
تەرەققى_تاپقان	tɛrɛqqi_tapqan
تەرەققى_قىلىۋاتقان	tɛrɛqqi_qiliwatqan
ئائىلىدە	ailidɛ
ئائىلىسى	ailisi
ئائىلىۋى	ailiwi
ئاتالغان	atalʁan
ئاتايمىز	atajmiz
ئاتتىڭمۇ	attiŋmu
ئاتلارنى	atlarni
ئاتىلىدۇ	atilidu
ئاتۇشلۇق	atuʃluq
ئاخىرىدا	aχirida
ئاخىرىقى	aχiriqi
ئاددىيلا	addijla
ئادەتتىن	adɛttin
ئادەمدىن	adɛmdin
ئادەملەر	adɛmlɛr
ئادەمنىڭ	adɛmniŋ
ئارامىدا	aramida
ئارزۇيۇم	arzujum
ئارسىدىن	arsidin
ئارغامچا	arʁamt͡ʃa
ئارقامغا	arqamʁa
ئارقىدىن	arqidin
ئارقىلىق	arqiliq
ئارلىقىم	arliqim
ئارىسىدا	arisida
ئارىلىنى	arilini
ئارچىلار	art͡ʃilar
ئارچېرغا	art͡ʃerʁa
ئارچېرنى	art͡ʃerni
ئازابلىق	azabliq
ئازابىنى	azabini
ئازراقلا	azraqla
ئازگالغا	azɡalʁa
ئاساسلىق	asasliq
ئاساسىدا	asasida
ئاسانكەن	asankɛn
ئاستىدىن	astidin
ئاستىنىڭ	astiniŋ
ئاسماندا	asmanda
ئاسمانغا	asmanʁa
ئاسماننى	asmanni
ئاشقاندا	aʃqanda
ئاغزىدىن	aʁzidin
ئاغزىڭغا	aʁziŋʁa
ئاقارغان	aqarʁan
ئاقساقال	aqsaqal
ئاقسامتى	aqsamti
ئاقسۆڭەك	aqsøŋɛk
ئاققۇلار	aqqular
ئاقكۆڭۈل	aqkøŋyl
ئاكىسىغا	akisiʁa
ئاكىسىنى	akisini
ئالامىتى	alamiti
ئالاھىدە	alahidɛ
ئالتىمىز	altimiz
ئالتىنچى	altint͡ʃi
ئالدامچى	aldamt͡ʃi
ئالدىراش	aldiraʃ
ئالدىراپ	aldirap
ئالدىمدا	aldimda
ئالدىنقى	aldinqi
ئالسىڭىز	alsiŋiz
ئالماقچى	almaqt͡ʃi
ئالمىشىپ	almiʃip
ئالىمجان	alimd͡ʒan
ئالىملار	alimlar
ئالۋاستى	alwasti
ئالەمنىڭ	alɛmniŋ
ئامالىنى	amalini
ئامىلدۇر	amildur
ئامېرىكا	amerika
ئانارلار	anarlar
ئانامدىن	anamdin
ئاناڭلار	anaŋlar
ئاناڭنىڭ	anaŋniŋ
ئانىسىغا	anisiʁa
ئاياللار	ajallar
ئايالنىڭ	ajalniŋ
ئايالىغا	ajaliʁa
ئايتۇغدى	ajtuʁdi
ئايرىلدى	ajrildi
ئايرىلسا	ajrilsa
ئايرىلىپ	ajrilip
ئايرىماي	ajrimaj
ئايرىيدۇ	ajrijdu
ئايلاردا	ajlarda
ئايلاندى	ajlandi
ئايلانسا	ajlansa
ئايلىنىپ	ajlinip
ئايىغىغا	ajiʁiʁa
ئاپامدىن	apamdin
ئاپتاپتا	aptapta
ئاپتوبۇس	aptobus
ئاپتونوم	aptonom
ئاپپارات	apparat
ئاچچىقىم	at͡ʃt͡ʃiqim
ئاڭلاشقا	aŋlaʃqa
ئاڭلاندى	aŋlandi
ئاڭلاپتۇ	aŋlaptu
ئاڭلاپلا	aŋlapla
ئاڭلىدىم	aŋlidim
ئاڭلىغان	aŋliʁan
ئاڭلىنىپ	aŋlinip
ئاۋازىمۇ	awazimu
ئاۋازىنى	awazini
ئاۋايلاپ	awajlap
ئشىنىمەن	eʃinimɛn
ئوتلاقتا	otlaqta
ئوتلاققا	otlaqqa
ئوخشاشلا	oχʃaʃla
ئوخشاشمۇ	oχʃaʃmu
ئوخشايدۇ	oχʃajdu
ئوردىكام	ordikam
ئورماندا	ormanda
ئورمانغا	ormanʁa
ئورنىدىن	ornidin
ئورۇنداش	orundaʃ
ئورۇندۇق	orunduq
ئورۇنلار	orunlar
ئوزۇقلۇق	ozuqluq
ئوغلاققا	oʁlaqqa
ئوغلاقنى	oʁlaqni
ئوغلۇمنى	oʁlumni
ئوغۇلنىڭ	oʁulniŋ
ئوقۇتساق	oqutsaq
ئوقۇشىغا	oquʃiʁa
ئوقۇغۇچى	oquʁut͡ʃi
ئولتۇردى	olturdi
ئولتۇرۇپ	olturup
ئوماچتەك	omat͡ʃtɛk
ئوياقتىن	ojaqtin
ئويغاتسا	ojʁatsa
ئويغاندى	ojʁandi
ئويغىتىپ	ojʁitip
ئويلايدۇ	ojlajdu
ئويلاپتۇ	ojlaptu
ئويلاپمۇ	ojlapmu
ئويلىدىم	ojlidim
ئويلىغان	ojliʁan
ئويلىنىپ	ojlinip
ئويناشقا	ojnaʃqa
ئويناپتۇ	ojnaptu
ئوينىدۇق	ojniduq
ئوينىغان	ojniʁan
ئوينىلىش	ojniliʃ
ئويۇنلار	ojunlar
ئويۇننىڭ	ojunniŋ
ئويۇنچۇق	ojunt͡ʃuq
ئوچۇملاپ	ot͡ʃumlap
ئوڭدىسغا	oŋdisʁa
ئوڭۇشلۇق	oŋuʃluq
ئوۋلىماي	owlimaj
ئوۋچىلىق	owt͡ʃiliq
ئوۋچىنىڭ	owt͡ʃiniŋ
ئىتتىرىپ	ittirip
ئىجتىھات	id͡ʒtihat
ئىدارىسى	idarisi
ئىدىيىسى	idijisi
ئىزباسار	izbasar
ئىزدىنىش	izdiniʃ
ئىزدىگەن	izdiɡɛn
ئىزدەشكە	izdɛʃkɛ
ئىزلارنى	izlarni
ئىستاكان	istakan
ئىسسىقتا	issiqta
ئىسسىققا	issiqqa
ئىسسىقنى	issiqni
ئىسمىمنى	ismimni
ئىسىملىك	isimlik
ئىسپىرىت	ispirit
ئىشتىياق	iʃtijaq
ئىشقىلىپ	iʃqilip
ئىشلارمۇ	iʃlarmu
ئىشلارنى	iʃlarni
ئىشلىتىش	iʃlitiʃ
ئىشلىتىپ	iʃlitip
ئىشلىنىپ	iʃlinip
ئىشلەتسە	iʃlɛtsɛ
ئىشلەشكە	iʃlɛʃkɛ
ئىشىكتىن	iʃiktin
ئىشىكىنى	iʃikini
ئىشەنسەم	iʃɛnsɛm
ئىشەنچكە	iʃɛnt͡ʃkɛ
ئىككىمىز	ikkimiz
ئىككىنچى	ikkint͡ʃi
ئىكەنسىز	ikɛnsiz
ئىلاڭگۇچ	ilaŋɡut͡ʃ
ئىلتىماس	iltimas
ئىنتايىن	intajin
ئىنتىزار	intizar
ئىنتىزام	intizam
ئىنتىلىپ	intilip
ئىنسانىي	insanij
ئىنكاسنى	inkasni
ئىپتىخار	iptiχar
ئىچكەندە	it͡ʃkɛndɛ
ئىچمەكچى	it͡ʃmɛkt͡ʃi
ئىچىدىكى	it͡ʃidiki
ئىچىدىلا	it͡ʃidila
ئىچىگىچە	it͡ʃiɡit͡ʃɛ
ئىگىلىكى	iɡiliki
ئىھتىيات	ihtijat
ئۆتكۈزۈش	øtkyzyʃ
ئۆتكۈزۈپ	øtkyzyp
ئۆتكەندە	øtkɛndɛ
ئۆتمۈشتە	øtmyʃtɛ
ئۆتمەكتە	øtmɛktɛ
ئۆتمەيلا	øtmɛjla
ئۆتۈشنىڭ	øtyʃniŋ
ئۆتۈشىگە	øtyʃiɡɛ
ئۆتەلمەي	øtɛlmɛj
ئۆردەككە	ørdɛkkɛ
ئۆرلىگەن	ørliɡɛn
ئۆزىگىلا	øziɡila
ئۆزگىرىپ	øzɡirip
ئۆزۇڭنىڭ	øzuŋniŋ
ئۆزۈمنىڭ	øzymniŋ
ئۆزۈڭدىن	øzyŋdin
ئۆزۈڭنىڭ	øzyŋniŋ
ئۆستۈرۈش	østyryʃ
ئۆستەڭچۇ	østɛŋt͡ʃu
ئۆستەڭگە	østɛŋɡɛ
ئۆسۈشىنى	øsyʃini
ئۆكتەبىر	øktɛbir
ئۆلتۈرۈش	øltyryʃ
ئۆلتۈرۈپ	øltyryp
ئۆلسەكمۇ	ølsɛkmu
ئۆلكىلىك	ølkilik
ئۆمرىمىز	ømrimiz
ئۆمرۈمدە	ømrymdɛ
ئۆيلەرنى	øjlɛrni
ئۆيلەرگە	øjlɛrɡɛ
ئۆيلەشكە	øjlɛʃkɛ
ئۆڭكۈرگە	øŋkyrɡɛ
ئۆگزىنىڭ	øɡziniŋ
ئۆگەتتىم	øɡɛttim
ئۆگەنسۇن	øɡɛnsun
ئۆگەنسەم	øɡɛnsɛm
ئۆگەنگەن	øɡɛnɡɛn
ئۇخلاشقا	uχlaʃqa
ئۇخلاشنى	uχlaʃni
ئۇخلاپمۇ	uχlapmu
ئۇرماقچى	urmaqt͡ʃi
ئۇزاقتىن	uzaqtin
ئۇزۇندىن	uzundin
ئۇستازنى	ustazni
ئۇقتۇردى	uqturdi
ئۇلاردىن	ulardin
ئۇلارنىڭ	ularniŋ
ئۇلۇغلاش	uluʁlaʃ
ئۇلۇغۋار	uluʁwar
ئۇنداقتا	undaqta
ئۇنىڭدىن	uniŋdin
ئۇنىڭسىز	uniŋsiz
ئۇنچىلىك	unt͡ʃilik
ئۇياتچان	ujatt͡ʃan
ئۇياقتىن	ujaqtin
ئۇيغۇرچە	ujʁurt͡ʃɛ
ئۇيقۇدىن	ujqudin
ئۇچرىشىپ	ut͡ʃriʃip
ئۇچرىغان	ut͡ʃriʁan
ئۇچىسىدا	ut͡ʃisida
ئۇچىسىغا	ut͡ʃisiʁa
ئۇچۇملاپ	ut͡ʃumlap
ئۈجمىنىڭ	yd͡ʒminiŋ
ئۈزۈشىنى	yzyʃini
ئۈزۈلمەي	yzylmɛj
ئۈزۈملەر	yzymlɛr
ئۈستەلگە	ystɛlɡɛ
ئۈلگىمىز	ylɡimiz
ئۈلگۈرۈپ	ylɡyryp
ئۈنۈملىك	ynymlik
ئۈچەيلەن	yt͡ʃɛjlɛn
ئېتىزلار	etizlar
ئېتىزلىق	etizliq
ئېتىقادى	etiqadi
ئېتىلدۇق	etilduq
ئېتىلغان	etilʁan
ئېرىشتىم	eriʃtim
ئېرىشكەن	eriʃkɛn
ئېرىشىدۇ	eriʃidu
ئېرىمنىڭ	erimniŋ
ئېسىلغان	esilʁan
ئېغىزلىق	eʁizliq
ئېغىزىغا	eʁiziʁa
ئېقىمىنى	eqimini
ئېقىنلار	eqinlar
ئېلىشىنى	eliʃini
ئېلىنغان	elinʁan
ئېلىڭلار	eliŋlar
ئېنىقراق	eniqraq
ئېيتسىلا	ejtsila
ئېيتقىلى	ejtqili
ئېيتقىنا	ejtqina
ئېيتىشقا	ejtiʃqa
ئېيتىمەن	ejtimɛn
ئېيتىپتۇ	ejtiptu
ئېچىرقاپ	et͡ʃirqap
ئېچىلغان	et͡ʃilʁan
ئېڭىشتىم	eŋiʃtim
ئېڭىكىنى	eŋikini
ئېھتىمال	ehtimal
ئېۋكىلىد	ewkilid
ئەتراپنى	ɛtrapni
ئەترەتتە	ɛtrɛttɛ
ئەتىگىنى	ɛtiɡini
ئەجىرىنى	ɛd͡ʒirini
ئەخمەقمۇ	ɛχmɛqmu
ئەدىبىنى	ɛdibini
ئەدىپىنى	ɛdipini
ئەرزىمەس	ɛrzimɛs
ئەزالىرى	ɛzaliri
ئەزەلدىن	ɛzɛldin
ئەسلىدىم	ɛslidim
ئەسەرلەر	ɛsɛrlɛr
ئەقىللىق	ɛqilliq
ئەكىرسەڭ	ɛkirsɛŋ
ئەكېلىدۇ	ɛkelidu
ئەكېلىڭە	ɛkeliŋɛ
ئەكەلدىم	ɛkɛldim
ئەلسۆيەر	ɛlsøjɛr
ئەللەرگە	ɛllɛrɡɛ
ئەلۋەتتە	ɛlwɛttɛ
ئەمگەكنى	ɛmɡɛkni
ئەمەستەك	ɛmɛstɛk
ئەمەسكەن	ɛmɛskɛn
ئەمەلدار	ɛmɛldar
ئەنسىرەپ	ɛnsirɛp
ئەيمىنىپ	ɛjminip
ئەينەككە	ɛjnɛkkɛ
ئەيىبلىك	ɛjiblik
ئەيىبلەپ	ɛjiblɛp
ئەپلىشىپ	ɛpliʃip
ئەھمىيەت	ɛhmijɛt
ئەھۋالغا	ɛhwalʁa
ئەھۋالنى	ɛhwalni
باتارىيە	batarijɛ
باراقسان	baraqsan
بارسىڭىز	barsiŋiz
بارغاندا	barʁanda
بارغانچە	barʁant͡ʃɛ
بارلىققا	barliqqa
بارمايلا	barmajla
بارىڭىغا	bariŋiʁa
بازاردىن	bazardin
بازارلار	bazarlar
بازىرىدا	bazirida
بازىرىغا	baziriʁa
باسالماي	basalmaj
باشقىلار	baʃqilar
باشقۇرۇش	baʃquruʃ
باشلاندى	baʃlandi
باشلاپتۇ	baʃlaptu
باشلىدىم	baʃlidim
باشلىدۇق	baʃliduq
باشلىغان	baʃliʁan
باشلىنىپ	baʃlinip
باغرىڭغا	baʁriŋʁa
باغلىغان	baʁliʁan
باغچىلار	baʁt͡ʃilar
باقتىڭمۇ	baqtiŋmu
باققانمۇ	baqqanmu
باقماقچى	baqmaqt͡ʃi
باقمىدىم	baqmidim
باقمىغان	baqmiʁan
بالدۇرلا	baldurla
بالىسىغۇ	balisiʁu
بالىلىرى	baliliri
بايقىدىم	bajqidim
بايقىدۇق	bajqiduq
بايقىغان	bajqiʁan
بايلارغا	bajlarʁa
بايلىققا	bajliqqa
باھارنىڭ	baharniŋ
بورسۇققا	borsuqqa
بوشلۇقتا	boʃluqta
بوشلۇققا	boʃluqqa
بولاتتىم	bolattim
بولاتتىڭ	bolattiŋ
بولدىغان	boldiʁan
بولدىكەن	boldikɛn
بولدىڭىز	boldiŋiz
بولساقمۇ	bolsaqmu
بولساممۇ	bolsammu
بولسامچۇ	bolsamt͡ʃu
بولساڭمۇ	bolsaŋmu
بولسىڭىز	bolsiŋiz
بولغاندا	bolʁanda
بولغاندۇ	bolʁandu
بولغاچقا	bolʁat͡ʃqa
بولغىنىم	bolʁinim
بولغۇلۇق	bolʁuluq
بولمامدۇ	bolmamdu
بولمايدۇ	bolmajdu
بولمايچۇ	bolmajt͡ʃu
بولمىغان	bolmiʁan
بولىدىغۇ	bolidiʁu
بولىدۇكى	boliduki
بولۇشنىڭ	boluʃniŋ
بولۇشىغا	boluʃiʁa
بولۇشىنى	boluʃini
بولۇنغان	bolunʁan
بويىدىكى	bojidiki
بوپتىكەن	boptikɛn
بوۋامدىن	bowamdin
بوۋاينىڭ	bowajniŋ
بىرتاللا	birtalla
بىردىنلا	birdinla
بىرقەدەر	birqɛdɛr
بىرلىشىپ	birliʃip
بىرمۇبىر	birmubir
بىرمۇنچە	birmunt͡ʃɛ
بىرنەچچە	birnɛt͡ʃt͡ʃɛ
بىرەرىنى	birɛrini
بىرەيلەن	birɛjlɛn
بىلدىڭىز	bildiŋiz
بىلدۈردى	bildyrdi
بىلمىسۇن	bilmisun
بىلمەكچى	bilmɛkt͡ʃi
بىلمەيلا	bilmɛjla
بىلوگىنى	biloɡini
بىلىملىك	bilimlik
بىلىنمەس	bilinmɛs
بىلىنىدۇ	bilinidu
بىلەتتىڭ	bilɛttiŋ
بىلەلمەي	bilɛlmɛj
بىلەمسىز	bilɛmsiz
بۆشۈكتەك	bøʃyktɛk
بۆشۈكى››	bøʃyki››
بۆلۈمنىڭ	bølymniŋ
بۇرچىمىز	burt͡ʃimiz
بۇرۇتىنى	burutini
بۇقۇلداپ	buquldap
بۇلارنىڭ	bularniŋ
بۇلاقتىن	bulaqtin
بۇلالماي	bulalmaj
بۇلغىنىش	bulʁiniʃ
بۇلۇتلار	bulutlar
بۇلۇقلاپ	buluqlap
بۇلۇڭلۇق	buluŋluq
بۇلۇڭىغا	buluŋiʁa
بۇنىڭدىن	buniŋdin
بۇيرۇققا	bujruqqa
بۇگۈندىن	buɡyndin
بۈگۈندىن	byɡyndin
بېجىرىدۇ	bed͡ʒiridu
بېرىشىنى	beriʃini
بېرىڭلار	beriŋlar
بېرىۋىدى	beriwidi
بېزەلگەن	bezɛlɡɛn
بېسىلغان	besilʁan
بېسىمىنى	besimini
بېشىدىكى	beʃidiki
بېغىرلاپ	beʁirlap
بېغىشلاپ	beʁiʃlap
بېقىڭلار	beqiŋlar
بېلىقلار	beliqlar
بېلىقنىڭ	beliqniŋ
بېلىكىگە	belikiɡɛ
بەخىتلىك	bɛχitlik
بەدىلىگە	bɛdiliɡɛ
بەدىنىدە	bɛdinidɛ
بەردىڭىز	bɛrdiŋiz
بەرمىسەم	bɛrmisɛm
بەرمەكتە	bɛrmɛktɛ
بەرمەكچى	bɛrmɛkt͡ʃi
بەرگەندە	bɛrɡɛndɛ
بەزىلىرى	bɛziliri
بەلگىلىك	bɛlɡilik
بەھرىمەن	bɛhrimɛn
تاتارغان	tatarʁan
تاراملاپ	taramlap
تارتاتتى	tartatti
تارتقىنى	tartqini
تارتىسەن	tartisɛn
تارتىشنى	tartiʃni
تارتىشىش	tartiʃiʃ
تارتىنىپ	tartinip
تارتىپتۇ	tartiptu
تارتىپلا	tartipla
تارقالدى	tarqaldi
تارقىتىپ	tarqitip
تارىختىن	tariχtin
تاشئالما	taʃalma
تاشلارغا	taʃlarʁa
تاشلارنى	taʃlarni
تاشلاشقا	taʃlaʃqa
تاشلاندى	taʃlandi
تاشلايدۇ	taʃlajdu
تاغلارغا	taʁlarʁa
تامىقىنى	tamiqini
تامچىلاپ	tamt͡ʃilap
تانىسىغا	tanisiʁa
تانىسىنى	tanisini
تاپتىڭىز	taptiŋiz
تاپشۇرۇش	tapʃuruʃ
تاپشۇرۇپ	tapʃurup
تاپماقتا	tapmaqta
تاپماقچى	tapmaqt͡ʃi
توختايدۇ	toχtajdu
توختاپتۇ	toχtaptu
توختىتىش	toχtitiʃ
توختىتىپ	toχtitip
توختىغان	toχtiʁan
توختىماي	toχtimaj
تورغاينى	torʁajni
تورىدىكى	toridiki
تورۇسىغا	torusiʁa
توساتتىن	tosattin
توشقانغا	toʃqanʁa
توغرسىدا	toʁrsida
توغرىدەك	toʁridɛk
توغرۇلۇق	toʁruluq
توققۇزدا	toqquzda
توقۇمىچى	toqumit͡ʃi
تولدۇردى	toldurdi
تومۇرنىڭ	tomurniŋ
تومۇرىغا	tomuriʁa
تونىنىنى	toninini
تونۇشلۇق	tonuʃluq
تونۇشىنى	tonuʃini
تويۇنغان	tojunʁan
توپتوغرا	toptoʁra
توپلىنىپ	toplinip
توۋلاپتۇ	towlaptu
توۋلىدىم	towlidim
توۋلىغان	towliʁan
تىترىگەن	titriɡɛn
تىجىگىلى	tid͡ʒiɡili
تىرامۋاي	tiramwaj
تىرىشچان	tiriʃt͡ʃan
تىرىليون	tiriljon
تىزلىكتە	tizliktɛ
تىزىلغان	tizilʁan
تىزگىننى	tizɡinni
تىكتۈرۈپ	tiktyryp
تىكلەشنى	tiklɛʃni
تىكىلگەن	tikilɡɛn
تىنىمسىز	tinimsiz
تىيىنلار	tijinlar
تىگىشلىك	tiɡiʃlik
تىۋىتلىك	tiwitlik
تىۋىشىنى	tiwiʃini
تۆلەشتىن	tølɛʃtin
تۆمۈرلەر	tømyrlɛr
تۆگىسىنى	tøɡisini
تۆۋەنلەپ	tøwɛnlɛp
تۇتاشقان	tutaʃqan
تۇتالماي	tutalmaj
تۇتماقچى	tutmaqt͡ʃi
تۇتىشىدۇ	tutiʃidu
تۇتۇشىدۇ	tutuʃidu
تۇخۇمدىن	tuχumdin
تۇخۇمىنى	tuχumini
تۇرسىڭىز	tursiŋiz
تۇرغاندا	turʁanda
تۇرغاچقا	turʁat͡ʃqa
تۇرماقتا	turmaqta
تۇرمامدۇ	turmamdu
تۇرمۇشتا	turmuʃta
تۇرمۇشقا	turmuʃqa
تۇرمۇشنى	turmuʃni
تۇرنىلار	turnilar
تۇرپاندا	turpanda
تۇرپانغا	turpanʁa
تۇرۇقلۇق	turuqluq
تۇساتتىن	tusattin
تۇغۇلغان	tuʁulʁan
تۇلۇمدەك	tulumdɛk
تۇنجۇقۇپ	tund͡ʒuqup
تۇيۇقسىز	tujuqsiz
تۈتۈندەك	tytyndɛk
تۈتەكلەر	tytɛklɛr
تۈرلەردە	tyrlɛrdɛ
تۈزلەڭنى	tyzlɛŋni
تۈلكىنىڭ	tylkiniŋ
تۈڭلۈككە	tyŋlykkɛ
تۈگىتىدۇ	tyɡitidu
تۈگىدىمۇ	tyɡidimu
تۈگىمىدى	tyɡimidi
تۈگەتكەن	tyɡɛtkɛn
تۈۋىمدىن	tywimdin
تېتىقسىز	tetiqsiz
تېجەشلىك	ted͡ʒɛʃlik
تېخىچىلا	teχit͡ʃila
تېرىسىنى	terisini
تېرەكتەك	terɛktɛk
تېرەكلەر	terɛklɛr
تېشىلگەن	teʃilɡɛn
تېغىدىكى	teʁidiki
تېلېگراف	teleɡraf
تېپىلغان	tepilʁan
تېگىدىكى	teɡidiki
تېگىشلىك	teɡiʃlik
تەبەسسۇم	tɛbɛssum
تەتقىقات	tɛtqiqat
تەجىرىبە	tɛd͡ʒiribɛ
تەدرىجىي	tɛdrid͡ʒij
تەرىقىدە	tɛriqidɛ
تەرىپلەپ	tɛriplɛp
تەرىپىدە	tɛripidɛ
تەرىپىنى	tɛripini
تەرىپىگە	tɛripiɡɛ
تەرپىدىن	tɛrpidin
تەرەققىي	tɛrɛqqij
تەرەپتىن	tɛrɛptin
تەرەپنىڭ	tɛrɛpniŋ
تەسىرلىك	tɛsirlik
تەسىرىدە	tɛsiridɛ
تەسەللىي	tɛsɛllij
تەسەۋۋۇر	tɛsɛwwur
تەشكىلىي	tɛʃkilij
تەشەككۇر	tɛʃɛkkur
تەقدىرنى	tɛqdirni
تەكتىدىن	tɛktidin
تەكشۈرۈش	tɛkʃyryʃ
تەكشۈرۈپ	tɛkʃyryp
تەلتۆكۈس	tɛltøkys
تەلەپچان	tɛlɛpt͡ʃan
تەنلىرىم	tɛnlirim
تەپسىلىي	tɛpsilij
تەڭرىتاغ	tɛŋritaʁ
تەڭشىگۈچ	tɛŋʃiɡyt͡ʃ
تەڭلىدىم	tɛŋlidim
تەڭلىمەي	tɛŋlimɛj
تەھدىتنى	tɛhditni
تەۋرىنىش	tɛwriniʃ
تەۋرىنىپ	tɛwrinip
جاملاردا	d͡ʒamlarda
جانلىنىپ	d͡ʒanlinip
جايلاردا	d͡ʒajlarda
جايلارغا	d͡ʒajlarʁa
جاھىللىق	d͡ʒahilliq
جۇغۇلداپ	d͡ʒuʁuldap
جۇڭگونىڭ	d͡ʒuŋɡoniŋ
جۈملىدىن	d͡ʒymlidin
جۈمەكتىن	d͡ʒymɛktin
جېنىمنىڭ	d͡ʒenimniŋ
جەرياندا	d͡ʒɛrjanda
جەريانىڭ	d͡ʒɛrjaniŋ
جەمئىيەت	d͡ʒɛmijɛt
جەمەتىگە	d͡ʒɛmɛtiɡɛ
جەنۇپتىن	d͡ʒɛnuptin
خاتىرجەم	χatird͡ʒɛm
خادىكنىڭ	χadikniŋ
خادىملار	χadimlar
خادىمنىڭ	χadimniŋ
خاراكتېر	χarakter
خالايمەن	χalajmɛn
خالىمىدى	χalimidi
خانىمنىڭ	χanimniŋ
خوشلىشىش	χoʃliʃiʃ
خوشلىشىپ	χoʃliʃip
خىرىلداپ	χirildap
خىزمەتچى	χizmɛtt͡ʃi
خىسلەتكە	χislɛtkɛ
خىلاپلىق	χilapliq
خىلمۇخىل	χilmuχil
خىياللار	χijallar
خىيالىغا	χijaliʁa
خىيالىمۇ	χijalimu
خۇشاللىق	χuʃalliq
خەتچىلەپ	χɛtt͡ʃilɛp
خەلقىنىڭ	χɛlqiniŋ
خەلىقلەر	χɛliqlɛr
خەلىقنىڭ	χɛliqniŋ
خەۋىرىنى	χɛwirini
داجىيتتى	dad͡ʒijtti
داجىپىتۇ	dad͡ʒipitu
دادامدىن	dadamdin
دادامنىڭ	dadamniŋ
دادىسىغا	dadisiʁa
دادىسىنى	dadisini
داستىخان	dastiχan
دانىشمەن	daniʃmɛn
داچەننىڭ	dat͡ʃɛnniŋ
داڭقېتىپ	daŋqetip
داۋالغۇپ	dawalʁup
داۋاملىق	dawamliq
داۋاندىن	dawandin
دوختۇرغا	doχturʁa
دوختۇرمۇ	doχturmu
دوستلىرى	dostliri
دوستۇمنى	dostumni
دوستۇڭغا	dostuŋʁa
دولىسىنى	dolisini
دومسىيىپ	domsijip
دىمىغىغا	dimiʁiʁa
دىپلومات	diplomat
دۆلەتلەر	dølɛtlɛr
دۆۋىسىگە	døwisiɡɛ
دۇباۋاغا	dubawaʁa
دۇدۇقلاپ	duduqlap
دۇكاننىڭ	dukanniŋ
دۇكىنىغا	dukiniʁa
دۇنيادىن	dunjadin
دۇنيانىڭ	dunjaniŋ
دېرىزىگە	deriziɡɛ
دېمىسىمۇ	demisimu
دېمەكتىن	demɛktin
دېمەڭلار	demɛŋlar
دېيشكىنى	dejʃkini
دېيىشىنى	dejiʃini
دېيىلىدۇ	dejilidu
دېڭىزلار	deŋizlar
دېڭىزىغا	deŋiziʁa
دېگىنىچە	deɡinit͡ʃɛ
دېگىنىگە	deɡiniɡɛ
دېگەندىن	deɡɛndin
دېگەندەك	deɡɛndɛk
دېگەنلەر	deɡɛnlɛr
دېگەنىدى	deɡɛnidi
دېۋگاتىل	dewɡatil
دەرىجىدە	dɛrid͡ʒidɛ
دەرىخىگە	dɛriχiɡɛ
دەرىسىنى	dɛrisini
دەريادىن	dɛrjadin
دەريانىڭ	dɛrjaniŋ
دەرەختىن	dɛrɛχtin
دەرەخلىك	dɛrɛχlik
دەرەخلەر	dɛrɛχlɛr
دەرەخنىڭ	dɛrɛχniŋ
دەسسەيدۇ	dɛssɛjdu
دەسلەپتە	dɛslɛptɛ
دەسلەپكى	dɛslɛpki
دەيدىكەن	dɛjdikɛn
دەپتىكەن	dɛptikɛn
دەپتەرگە	dɛptɛrɡɛ
دەپسەندە	dɛpsɛndɛ
دەۋرىمنى	dɛwrimni
دەۋەتتىم	dɛwɛttim
رادىينىڭ	radijniŋ
راستىنلا	rastinla
راسلىدىم	raslidim
رايونىدا	rajonida
رىتىمىدە	ritimidɛ
رىشتىڭىز	riʃtiŋiz
رېلىسلار	relislar
رەسىملەر	rɛsimlɛr
رەسىمىمۇ	rɛsimimu
رەڭلەردە	rɛŋlɛrdɛ
رەڭمۇرەڭ	rɛŋmurɛŋ
رەڭگارەڭ	rɛŋɡarɛŋ
زامانىۋى	zamaniwi
زىرىكتۇق	ziriktuq
زىممەڭگە	zimmɛŋɡɛ
زىمىستان	zimistan
زىيانلىق	zijanliq
زىياپىتى	zijapiti
زەمبىرەك	zɛmbirɛk
زەينىدىن	zɛjnidin
زەھەرلىك	zɛhɛrlik
سائىتىگە	saitiɡɛ
سائەتتىن	saɛttin
سائەتلىك	saɛtlik
سادىقنىڭ	sadiqniŋ
ساراڭدىن	saraŋdin
ساراڭدەك	saraŋdɛk
سارغىيىپ	sarʁijip
سازلارنى	sazlarni
ساقاللىق	saqalliq
ساقلىتىپ	saqlitip
ساقلىغان	saqliʁan
ساقلىنىش	saqliniʃ
سالماقچى	salmaqt͡ʃi
سانايمەن	sanajmɛn
سانلارنى	sanlarni
سايلاشنى	sajlaʃni
سايماندا	sajmanda
سايىسىغا	sajisiʁa
سايىسىمۇ	sajisimu
ساپسېرىق	sapseriq
ساڭگىلاپ	saŋɡilap
ساھىلىدە	sahilidɛ
ساۋابلىق	sawabliq
ساۋاتلىق	sawatliq
ساۋاتنىڭ	sawatniŋ
ساۋاتىنى	sawatini
ساۋاقداش	sawaqdaʃ
سوئالنىڭ	soalniŋ
سودىدىكى	sodidiki
سودىسىغا	sodisiʁa
سودىگىرى	sodiɡiri
سورىمىدى	sorimidi
سورىۋىدى	soriwidi
سورۇنىغا	soruniʁa
سوزۇلغان	sozulʁan
سوغۇقتىن	soʁuqtin
سوغۇقراق	soʁuqraq
سوقۇشىنى	soquʃini
سوممىلىق	sommiliq
سوۋغاتمۇ	sowʁatmu
سىرلارنى	sirlarni
سىرلىقكى	sirliqki
سىزغۇچنى	sizʁut͡ʃni
سىزىقىدا	siziqida
سىلەرنىڭ	silɛrniŋ
سىمابتەك	simabtɛk
سىناقتىن	sinaqtin
سىنچىلاپ	sint͡ʃilap
سىياقىغا	sijaqiʁa
سۆرۈنلۈك	sørynlyk
سۆزلىگىن	søzliɡin
سۆزلەرنى	søzlɛrni
سۆزلەپتۇ	søzlɛptu
سۆزۈمدىن	søzymdin
سۆلەتلىك	sølɛtlik
سۆيمەيدۇ	søjmɛjdu
سۆيۈملۇك	søjymluk
سۆيۈملۈك	søjymlyk
سۆڭەكنىڭ	søŋɛkniŋ
سۇلىرىنى	sulirini
سۇندۇردى	sundurdi
سۈرئەتتە	syrɛttɛ
سۈرىتىنى	syritini
سۈرۈشنىڭ	syryʃniŋ
سۈكۈتتىن	sykyttin
سۈكۈتنىڭ	sykytniŋ
سۈپسۈزۈك	sypsyzyk
سۈپىتىدە	sypitidɛ
سېغىزخان	seʁizχan
سېلىشنىڭ	seliʃniŋ
سېلىنغان	selinʁan
سېيرىلىپ	sejrilip
سەبىيلەر	sɛbijlɛr
سەكرىشىپ	sɛkriʃip
سەكرەپتۇ	sɛkrɛptu
سەككىزنى	sɛkkizni
سەككىزگە	sɛkkizɡɛ
سەمرىشكە	sɛmriʃkɛ
سەپسېلىپ	sɛpselip
سەپىرىگە	sɛpiriɡɛ
سەھرادىن	sɛhradin
سەھرالىق	sɛhraliq
سەۋىيەدە	sɛwijɛdɛ
سەۋىيەسى	sɛwijɛsi
سەۋەنلىك	sɛwɛnlik
شادلىققا	ʃadliqqa
شارتتىدە	ʃarttidɛ
شارقىراپ	ʃarqirap
شارىدىكى	ʃaridiki
شاللىنىپ	ʃallinip
شامىلىدا	ʃamilida
شوينىلار	ʃojnilar
شىركەتكە	ʃirkɛtkɛ
شىمالدىن	ʃimaldin
شىنجاڭدا	ʃind͡ʒaŋda
شىياۋجاڭ	ʃijawd͡ʒaŋ
شىپالنىڭ	ʃipalniŋ
شىۋىرغان	ʃiwirʁan
شىۋىرلاپ	ʃiwirlap
شۇرقىراپ	ʃurqirap
شۇنداقلا	ʃundaqla
شۇنداقمۇ	ʃundaqmu
شۇنىڭدىن	ʃuniŋdin
شۇنىڭدەك	ʃuniŋdɛk
شۇنچىلىك	ʃunt͡ʃilik
شۇڭغۇغان	ʃuŋʁuʁan
شۈركىنىپ	ʃyrkinip
شۈمشىيىپ	ʃymʃijip
شەبنەممۇ	ʃɛbnɛmmu
شەتلەرنى	ʃɛtlɛrni
شەرەپلىك	ʃɛrɛplik
شەكلىمنى	ʃɛklimni
شەكىلنىڭ	ʃɛkilniŋ
شەكىلىدە	ʃɛkilidɛ
شەلۋەرەپ	ʃɛlwɛrɛp
شەپىسىنى	ʃɛpisini
شەھەردىن	ʃɛhɛrdin
شەھەرلىك	ʃɛhɛrlik
غالتەكتە	ʁaltɛktɛ
غالتەكنى	ʁaltɛkni
غوزەكتىن	ʁozɛktin
غۇرقىراپ	ʁurqirap
غۇيۇلداپ	ʁujuldap
غەزەپلىك	ʁɛzɛplik
غەلبىلىك	ʁɛlbilik
غەيرەتكە	ʁɛjrɛtkɛ
فامىلىسى	familisi
فرانسىيە	fransijɛ
فوتوگراف	fotoɡraf
قائىدىسى	qaidisi
قاتارلىق	qatarliq
قاتارىدا	qatarida
قاتاڭغۇر	qataŋʁur
قاتمىغان	qatmiʁan
قاتنىشىش	qatniʃiʃ
قاتنىشىپ	qatniʃip
قاراتقان	qaratqan
قاراشلىق	qaraʃliq
قارالغان	qaralʁan
قارامتۇل	qaramtul
قارايتتى	qarajtti
قاراڭلار	qaraŋlar
قارسسىدە	qarssidɛ
قارلىغاچ	qarliʁat͡ʃ
قارنىنىڭ	qarniniŋ
قارىتىدۇ	qaritidu
قارىسىلا	qarisila
قارىسىمۇ	qarisimu
قارىشىغا	qariʃiʁa
قارىغىنا	qariʁina
قاشتاشچى	qaʃtaʃt͡ʃi
قاشقالىق	qaʃqaliq
قاقاسلىق	qaqasliq
قاقاقلاپ	qaqaqlap
قاقمىدۇق	qaqmiduq
قالاتتىم	qalattim
قالارسىز	qalarsiz
قالدىغان	qaldiʁan
قالدىمغۇ	qaldimʁu
قالدىڭىز	qaldiŋiz
قالدۇردى	qaldurdi
قالدۇرۇپ	qaldurup
قالغاندا	qalʁanda
قالغاندۇ	qalʁandu
قالغاچقا	qalʁat͡ʃqa
قالغۇدەك	qalʁudɛk
قالماقچى	qalmaqt͡ʃi
قالمايدۇ	qalmajdu
قالمايلا	qalmajla
قالماپتۇ	qalmaptu
قالمىدۇق	qalmiduq
قالمىسۇن	qalmisun
قامچىلاپ	qamt͡ʃilap
قامۇستۇر	qamustur
قامەتلىك	qamɛtlik
قاناسنىڭ	qanasniŋ
قانداقمۇ	qandaqmu
قاندىغاي	qandiʁaj
قانچىلىك	qant͡ʃilik
قايتايلى	qajtajli
قايتىدىن	qajtidin
قايتۇرۇپ	qajturup
قايرىشىپ	qajriʃip
قايناتتى	qajnatti
قايىللىق	qajilliq
قاپتىمەن	qaptimɛn
قاپلىغان	qapliʁan
قاپلىنىپ	qaplinip
قاپىقىنى	qapiqini
قاچىسىمۇ	qat͡ʃisimu
قاچۇرغان	qat͡ʃurʁan
قوراللىق	qoralliq
قورققۇسى	qorqqusi
قورۇقلار	qoruqlar
قورۇنغان	qorunʁan
قوزغالدى	qozʁaldi
قوزغايدۇ	qozʁajdu
قوزغىلىش	qozʁiliʃ
قوشماقتا	qoʃmaqta
قوغلاشقا	qoʁlaʃqa
قولىدىكى	qolidiki
قولۇمدىن	qolumdin
قولۇڭدىن	qoluŋdin
قونمىغان	qonmiʁan
قويسىڭىز	qojsiŋiz
قويغاندى	qojʁandi
قويغاندۇ	qojʁandu
قويغۇممۇ	qojʁummu
قويلارنى	qojlarni
قويماقچى	qojmaqt͡ʃi
قويمايلا	qojmajla
قويماپتۇ	qojmaptu
قويۇلغان	qojulʁan
قويۇندەك	qojundɛk
قويۇپسەن	qojupsɛn
قويۇۋىدى	qojuwidi
قوچىقىنى	qot͡ʃiqini
قوڭغۇراق	qoŋʁuraq
قوڭغۇزنى	qoŋʁuzni
قىرغاقتا	qirʁaqta
قىرغاققا	qirʁaqqa
قىزلارغا	qizlarʁa
قىزلىرىم	qizlirim
قىزىقكەن	qiziqkɛn
قىزىلتاغ	qiziltaʁ
قىزچاققا	qizt͡ʃaqqa
قىزچاقمۇ	qizt͡ʃaqmu
قىستىلىپ	qistilip
قىستۇردى	qisturdi
قىسقىراپ	qisqirap
قىلاتتىڭ	qilattiŋ
قىلاتتۇق	qilattuq
قىلارمەن	qilarmɛn
قىلارىنى	qilarini
قىلالماي	qilalmaj
قىلامدۇق	qilamduq
قىلامسىز	qilamsiz
قىلدۇردى	qildurdi
قىلدۇرۇپ	qildurup
قىلسىڭىز	qilsiŋiz
قىلشىدىن	qilʃidin
قىلغاندا	qilʁanda
قىلغايلا	qilʁajla
قىلغىنىم	qilʁinim
قىلغۇدەك	qilʁudɛk
قىلماقتا	qilmaqta
قىلماقچى	qilmaqt͡ʃi
قىلمايتى	qilmajti
قىلمايدۇ	qilmajdu
قىلمايمۇ	qilmajmu
قىلماپتۇ	qilmaptu
قىلمىدىم	qilmidim
قىلمىساق	qilmisaq
قىلمىسام	qilmisam
قىلمىغان	qilmiʁan
قىلىشنىڭ	qiliʃniŋ
قىلىشىغا	qiliʃiʁa
قىلىنغان	qilinʁan
قىلىنىدۇ	qilinidu
قىممەتكە	qimmɛtkɛ
قىيمىغان	qijmiʁan
قىپسەنغۇ	qipsɛnʁu
قىپقىزىل	qipqizil
قۇتقۇزدى	qutquzdi
قۇتقۇزۇش	qutquzuʃ
قۇدۇقلار	quduqlar
قۇراقلار	quraqlar
قۇرتىنىڭ	qurtiniŋ
قۇرۇقتاغ	quruqtaʁ
قۇرۇقتىن	quruqtin
قۇرۇقلۇق	quruqluq
قۇرۇلغان	qurulʁan
قۇرۇلۇشى	quruluʃi
قۇشلارنى	quʃlarni
قۇشلارىم	quʃlarim
قۇلاقتىن	qulaqtin
قۇلايلىق	qulajliq
قۇلىقىغا	quliqiʁa
قۇملۇققا	qumluqqa
قۇياشتىن	qujaʃtin
قۇياشتەك	qujaʃtɛk
قۇياشنىڭ	qujaʃniŋ
قۇيۇلىدۇ	qujulidu
قۇچاقلاپ	qut͡ʃaqlap
قۇچىغىغا	qut͡ʃiʁiʁa
قېتىمدىن	qetimdin
قېتىملىق	qetimliq
قېرىنىنى	qerinini
قېلىشتىن	qeliʃtin
قېلىنراق	qelinraq
قېيىننىڭ	qejinniŋ
قەدىرلىك	qɛdirlik
قەدىمدىن	qɛdimdin
قەغىزىنى	qɛʁizini
قەغىزىگە	qɛʁiziɡɛ
قەغەزنىڭ	qɛʁɛzniŋ
قەلبىنىڭ	qɛlbiniŋ
قەلبىڭىز	qɛlbiŋiz
قەلەندەر	qɛlɛndɛr
قەمىردىن	qɛmirdin
قەيسەرگە	qɛjsɛrɡɛ
قەيەردىن	qɛjɛrdin
قەھرىتان	qɛhritan
كاتېردىن	katerdin
كارامىتى	karamiti
كارىزلار	karizlar
كارىزنىڭ	karizniŋ
كاسىسىمۇ	kasisimu
كاللامغا	kallamʁa
كانىيىنى	kanijini
كاۋاساكى	kawasaki
كاۋكازچە	kawkazt͡ʃɛ
كاۋىسىغا	kawisiʁa
كولانغان	kolanʁan
كوچىسىدا	kot͡ʃisida
كىتابنىڭ	kitabniŋ
كىتىپسەن	kitipsɛn
كىرمەكتە	kirmɛktɛ
كىرپىنىڭ	kirpiniŋ
كىرگەندە	kirɡɛndɛ
كىشىلىرى	kiʃiliri
كىلاۋچىك	kilawt͡ʃik
كىلىشىگە	kiliʃiɡɛ
كىيمەپتۇ	kijmɛptu
كىيىملەر	kijimlɛr
كىيىمنىڭ	kijimniŋ
كىيىمىنى	kijimini
كىيىمىگە	kijimiɡɛ
كىيگۈزۈپ	kijɡyzyp
كىيەتتىم	kijɛttim
كىچككىنە	kit͡ʃkkinɛ
كىچىدىلا	kit͡ʃidila
كىچىكلەپ	kit͡ʃiklɛp
كۆردىڭىز	kørdiŋiz
كۆردۈمكى	kørdymki
كۆردۈڭمۇ	kørdyŋmu
كۆرسىتىش	kørsitiʃ
كۆرسىتىپ	kørsitip
كۆرسەتتى	kørsɛtti
كۆرمىدىم	kørmidim
كۆرمىدۇق	kørmiduq
كۆرمىگەن	kørmiɡɛn
كۆرمەيدۇ	kørmɛjdu
كۆرمەپتۇ	kørmɛptu
كۆرپىلەر	kørpilɛr
كۆرگەزمە	kørɡɛzmɛ
كۆرگەندە	kørɡɛndɛ
كۆرۆنىدۇ	kørønidu
كۆرۈنمەس	kørynmɛs
كۆرۈنىدۇ	kørynidu
كۆرۈنگەن	kørynɡɛn
كۆرۈڭلار	køryŋlar
كۆرەڭلىك	kørɛŋlik
كۆرەڭلەپ	kørɛŋlɛp
كۆزلىرىڭ	køzliriŋ
كۆزىتىدۇ	køzitidu
كۆزىتىشى	køzitiʃi
كۆزەتكەن	køzɛtkɛn
كۆللەردە	køllɛrdɛ
كۆللەرنى	køllɛrni
كۆلىمىنى	kølimini
كۆلچەككە	kølt͡ʃɛkkɛ
كۆمۈردەك	kømyrdɛk
كۆمۈرنىڭ	kømyrniŋ
كۆنۈككەن	kønykkɛn
كۆيدۈرۈش	køjdyryʃ
كۆيۈنىدۇ	køjynidu
كۆيەرلىك	køjɛrlik
كۆپتۈرۈپ	køptyryp
كۆپلىگەن	køpliɡɛn
كۆپچىلىك	køpt͡ʃilik
كۆچىتىنى	køt͡ʃitini
كۆچۈرگەن	køt͡ʃyrɡɛn
كۆڭلىكىم	køŋlikim
كۆڭلۈمدە	køŋlymdɛ
كۆڭلۈمنى	køŋlymni
كۆڭلۈمگە	køŋlymɡɛ
كۆڭلەكنى	køŋlɛkni
كۆڭۈللۈك	køŋyllyk
كۇرسىنىڭ	kursiniŋ
كۇلۇبىغا	kulubiʁa
كۇنتۇغدى	kuntuʁdi
كۈتمەكتە	kytmɛktɛ
كۈتمەيلا	kytmɛjla
كۈلكىسىز	kylkisiz
كۈلكىلىك	kylkilik
كۈلكىنىڭ	kylkiniŋ
كۈنتۇغدى	kyntuʁdi
كۈندىلىك	kyndilik
كۈندۈزنى	kyndyzni
كۈنلەردە	kynlɛrdɛ
كۈنلەرگە	kynlɛrɡɛ
كۈنۈڭلار	kynyŋlar
كۈچىسىمۇ	kyt͡ʃisimu
كۈچۈكلەر	kyt͡ʃyklɛr
كۈچەيتىش	kyt͡ʃɛjtiʃ
كېتىشتىن	ketiʃtin
كېتىڭلار	ketiŋlar
كېرەكلىك	kerɛklik
كېلىنگەن	kelinɡɛn
كېلەتتىم	kelɛttim
كېمىسىدە	kemisidɛ
كېيىكتەك	kejiktɛk
كېچىدىكى	ket͡ʃidiki
كېچىدىلا	ket͡ʃidila
كېچىگىچە	ket͡ʃiɡit͡ʃɛ
كەتسەڭمۇ	kɛtsɛŋmu
كەتكۈدەك	kɛtkydɛk
كەتكەندۇ	kɛtkɛndu
كەتكەچكە	kɛtkɛt͡ʃkɛ
كەتمەكچى	kɛtmɛkt͡ʃi
كەتمەمدۇ	kɛtmɛmdu
كەتمەنگە	kɛtmɛnɡɛ
كەتمەيدۇ	kɛtmɛjdu
كەشپىيات	kɛʃpijat
كەلتۈرۈپ	kɛltyryp
كەلدىكىن	kɛldikin
كەلمىگەن	kɛlmiɡɛn
كەلمەكتە	kɛlmɛktɛ
كەلمەكچى	kɛlmɛkt͡ʃi
كەلمەيدۇ	kɛlmɛjdu
كەلمەپتۇ	kɛlmɛptu
كەلگۈدەك	kɛlɡydɛk
كەلگەندۇ	kɛlɡɛndu
كەلگەندە	kɛlɡɛndɛ
كەنتتىكى	kɛnttiki
كەينىدىن	kɛjnidin
كەينىمگە	kɛjnimɡɛ
كەيپىيات	kɛjpijat
كەپتۇدەك	kɛptudɛk
كەچقۇرۇن	kɛt͡ʃqurun
لايلىنىپ	lajlinip
لاۋزىنىڭ	lawziniŋ
لاۋۇلداپ	lawuldap
لوياڭنىڭ	lojaŋniŋ
لىغىرلاپ	liʁirlap
لىملارغا	limlarʁa
لىڭشىتىپ	liŋʃitip
لۆمۈلدەپ	lømyldɛp
لۇتپۇللا	lutpulla
لېتكىنىڭ	letkiniŋ
لەقىمىنى	lɛqimini
لەپىلدەپ	lɛpildɛp
ماتراسقا	matrasqa
ماتوردىن	matordin
ماتورنىڭ	matorniŋ
ماختاشقا	maχtaʃqa
ماختىشىپ	maχtiʃip
ماشىنىسى	maʃinisi
ماشىنىنى	maʃinini
ماقاللار	maqallar
ماقالىنى	maqalini
مامكاپنى	mamkapni
مامۇقتەك	mamuqtɛk
ماياقلار	majaqlar
مايسىلار	majsilar
مايمۇنغا	majmunʁa
ماڭغاندا	maŋʁanda
ماڭغۇدەك	maŋʁudɛk
ماڭماقتا	maŋmaqta
ماھارىتى	mahariti
ماھىرلىق	mahirliq
ماھىيىتى	mahijiti
مودىلىنى	modilini
مومىسىغا	momisiʁa
مويسىپىت	mojsipit
مىتاللار	mitallar
مىسرالىق	misraliq
مىسىلداپ	misildap
مىقداردا	miqdarda
مىلادىيە	miladijɛ
مىليونغا	miljonʁa
مىلەنگەن	milɛnɡɛn
مىچىلداپ	mit͡ʃildap
مىڭلىغان	miŋliʁan
مۆجىزىنى	mød͡ʒizini
مۆكۈشمەك	møkyʃmɛk
مۆلچەرگە	mølt͡ʃɛrɡɛ
مۇئامىلە	muamilɛ
مۇئەللىم	muɛllim
مۇئەييەن	muɛjjɛn
مۇدىرنىڭ	mudirniŋ
مۇرەككەپ	murɛkkɛp
مۇزىكىغا	muzikiʁa
مۇساپىنى	musapini
مۇستەقىل	mustɛqil
مۇشۇنداق	muʃundaq
مۇقەددەس	muqɛddɛs
مۇكەممەل	mukɛmmɛl
مۇلاھىزە	mulahizɛ
مۇنارنىڭ	munarniŋ
مۇنارىنى	munarini
مۇھاكىمە	muhakimɛ
مۇھىتىنى	muhitini
مۇھەببەت	muhɛbbɛt
مۇۋەپپەق	muwɛppɛq
مۈرىسىگە	myrisiɡɛ
مۈكۈشمەك	mykyʃmɛk
مېتىردىن	metirdin
مېنىڭدىن	meniŋdin
مېنىڭدەك	meniŋdɛk
مېنۇتلۇق	menutluq
مېڭىشتىن	meŋiʃtin
مېھرىبان	mehriban
مېھرىدىن	mehridin
مەبلەغقە	mɛblɛʁqɛ
مەخلۇقات	mɛχluqat
مەخمەلگە	mɛχmɛlɡɛ
مەرگەننى	mɛrɡɛnni
مەرھەمەت	mɛrhɛmɛt
مەزمۇندا	mɛzmunda
مەسئۇتقا	mɛsutqa
مەسئۇتنى	mɛsutni
مەسلىھەت	mɛslihɛt
مەسىلىنى	mɛsilini
مەسەللەر	mɛsɛllɛr
مەشئەلگە	mɛʃɛlɡɛ
مەشرەپكە	mɛʃrɛpkɛ
مەشىرىپى	mɛʃiripi
مەقسىتىم	mɛqsitim
مەكتەپتە	mɛktɛptɛ
مەكتەپكە	mɛktɛpkɛ
مەكتەپنى	mɛktɛpni
مەنىسىنى	mɛnisini
مەنپەئەت	mɛnpɛɛt
مەيداندا	mɛjdanda
مەيدانغا	mɛjdanʁa
مەڭگۈلۈك	mɛŋɡylyk
مەھسۇلات	mɛhsulat
ناملاردا	namlarda
نامىنىمۇ	naminimu
ناھايىتى	nahajiti
ناھىيىسى	nahijisi
ناھىيىگە	nahijiɡɛ
نىيىتىنى	nijitini
نىيىتىگە	nijitiɡɛ
نۆۋىتىدە	nøwitidɛ
نۇسخىسىى	nusχisii
نۇسخىلار	nusχilar
نېفىتىكە	nefitikɛ
نېمانداق	nemandaq
نېمىگىدۇ	nemiɡidu
نەتىجىدە	nɛtid͡ʒidɛ
نەتىجىسى	nɛtid͡ʒisi
نەدىندۇر	nɛdindur
نەرسىلەر	nɛrsilɛr
نەزىرىدە	nɛziridɛ
نەلەردىن	nɛlɛrdin
نەپەستىن	nɛpɛstin
نەۋرەممۇ	nɛwrɛmmu
ياتامدۇق	jatamduq
ياتقۇزۇپ	jatquzup
ياخشىكەن	jaχʃikɛn
ياخشىلاش	jaχʃilaʃ
يادلاشقا	jadlaʃqa
ياراتقان	jaratqan
يارامسىز	jaramsiz
ياراملىق	jaramliq
يارايسەن	jarajsɛn
ياردەمگە	jardɛmɡɛ
ياسانغان	jasanʁan
ياسايتتى	jasajtti
ياسايمەن	jasajmɛn
ياساپسەن	jasapsɛn
ياشانغان	jaʃanʁan
ياشايتتى	jaʃajtti
ياشلىققا	jaʃliqqa
ياشىغىلى	jaʃiʁili
ياغىچىغا	jaʁit͡ʃiʁa
ياقتۇرۇپ	jaqturup
ياقىسىدا	jaqisida
ياقۇتتەك	jaquttɛk
يالتىراپ	jaltirap
يالغانچى	jalʁant͡ʃi
يالماۋۇز	jalmawuz
يامىنىغا	jaminiʁa
يانتۇلۇق	jantuluq
ياندۇرما	jandurma
ياندۇرۇپ	jandurup
يانمۇيان	janmujan
يايلاقتا	jajlaqta
ياپمايلا	japmajla
ياپونىيە	japonijɛ
ياپيېشىل	japjeʃil
ياڭراتتى	jaŋratti
ياڭرىغان	jaŋriʁan
يورۇشىغا	joruʃiʁa
يورۇغىچە	joruʁit͡ʃɛ
يورۇقلۇق	joruqluq
يورۇقىدا	joruqida
يوقلۇققا	joqluqqa
يوقىتىدۇ	joqitidu
يوللىدۇق	jolliduq
يوللىساق	jollisaq
يولىدىكى	jolidiki
يوليورۇق	joljoruq
يوپۇرماق	jopurmaq
يىتەرلىك	jitɛrlik
يىراقتىن	jiraqtin
يىرىڭلىق	jiriŋliq
يىغلاشقا	jiʁlaʃqa
يىغلىغان	jiʁliʁan
يىغلىماڭ	jiʁlimaŋ
يىغىنىدا	jiʁinida
يىلاندەك	jilandɛk
يىللاردا	jillarda
يىللارنى	jillarni
يىللارنڭ	jillarnŋ
يىپەكلەر	jipɛklɛr
يىگىتتىن	jiɡittin
يىگىتلىك	jiɡitlik
يىگىتنىڭ	jiɡitniŋ
يۆتكىدۇق	jøtkiduq
يۆتكىلىپ	jøtkilip
يۇرتىمىز	jurtimiz
يۇقۇملۇق	juqumluq
يۇلتۇزغا	jultuzʁa
يۇمۇردىن	jumurdin
يۇيۇنغاچ	jujunʁat͡ʃ
يۈرسەكمۇ	jyrsɛkmu
يۈرگەندە	jyrɡɛndɛ
يۈرەكلىك	jyrɛklik
يۈرەكنىڭ	jyrɛkniŋ
يېتىشىچە	jetiʃit͡ʃɛ
يېتىلىشى	jetiliʃi
يېتەلمەي	jetɛlmɛj
يېتەلىشى	jetɛliʃi
يېزىدىكى	jezidiki
يېزىلغان	jezilʁan
يېزىپسىز	jezipsiz
يېشىدىكى	jeʃidiki
يېشىدىلا	jeʃidila
يېشىمنىڭ	jeʃimniŋ
يېقىملىق	jeqimliq
يېقىندىن	jeqindin
يېقىنراق	jeqinraq
يېقىنلاپ	jeqinlap
يېلىنجاپ	jelind͡ʒap
يېمەيتتى	jemɛjtti
يېنىدىكى	jenidiki
يېنىشىنى	jeniʃini
يېنىكلەپ	jeniklɛp
يېيىشىدۇ	jejiʃidu
يېيىلىدۇ	jejilidu
يېپىشقاق	jepiʃqaq
يەتكۈزۈش	jɛtkyzyʃ
يەتكۈزۈپ	jɛtkyzyp
يەتمىگەن	jɛtmiɡɛn
يەتمەيدۇ	jɛtmɛjdu
يەتمەپتۇ	jɛtmɛptu
يەرلەردە	jɛrlɛrdɛ
يەرلەرگە	jɛrlɛrɡɛ
يەكۈنلەپ	jɛkynlɛp
يەيدىغان	jɛjdiʁan
يەۋالسام	jɛwalsam
يەۋالغىن	jɛwalʁin
پاتقاققا	patqaqqa
پاتقاندا	patqanda
پاتنىتقا	patnitqa
پاتۇشكىن	patuʃkin
پاختىدىن	paχtidin
پاختىلار	paχtilar
پاختىلىق	paχtiliq
پاخورنىڭ	paχorniŋ
پادىشاھى	padiʃahi
پاراڭنىڭ	paraŋniŋ
پارقىراق	parqiraq
پارقىراپ	parqirap
پاكارراق	pakarraq
پالاقشىپ	palaqʃip
پالتىلار	paltilar
پايانسىز	pajansiz
پايدىلىق	pajdiliq
پايپېتەك	pajpetɛk
پوكاندەك	pokandɛk
پىرىنسىپ	pirinsip
پىشمىغان	piʃmiʁan
پىژغىرىم	piʒʁirim
پۆپۈكلۈك	pøpyklyk
پۇراقلار	puraqlar
پۇرسەتنى	pursɛtni
پۇرىقىنى	puriqini
پۇشايمان	puʃajman
پۇقرالار	puqralar
پۈتۈنلەي	pytynlɛj
پۈركەندى	pyrkɛndi
پۈۋلەشكە	pywlɛʃkɛ
پۈۋلەپتۇ	pywlɛptu
پېتېرنىڭ	peterniŋ
پەشتاقنى	pɛʃtaqni
چارلىشىپ	t͡ʃarliʃip
چاغلاردا	t͡ʃaʁlarda
چاغلىرىم	t͡ʃaʁlirim
چاغلىرىڭ	t͡ʃaʁliriŋ
چاقنايدۇ	t͡ʃaqnajdu
چاقنىغان	t͡ʃaqniʁan
چاقىردىم	t͡ʃaqirdim
چاقىرغان	t͡ʃaqirʁan
چاقپەلەك	t͡ʃaqpɛlɛk
چالدۇرۇپ	t͡ʃaldurup
چايقاپتۇ	t͡ʃajqaptu
چايقىلىپ	t͡ʃajqilip
چاپاننىڭ	t͡ʃapanniŋ
چاپتۇرۇپ	t͡ʃapturup
چاپچىشقا	t͡ʃapt͡ʃiʃqa
چاچراتتى	t͡ʃat͡ʃratti
چاچلىرىڭ	t͡ʃat͡ʃliriŋ
چشىلەپتۇ	t͡ʃʃilɛptu
چوقچىيىپ	t͡ʃoqt͡ʃijip
چوكاننىڭ	t͡ʃokanniŋ
چوڭلارغا	t͡ʃoŋlarʁa
چوڭىيىشى	t͡ʃoŋijiʃi
چىداملىق	t͡ʃidamliq
چىدايمەن	t͡ʃidajmɛn
چىراغنىڭ	t͡ʃiraʁniŋ
چىراقنىڭ	t͡ʃiraqniŋ
چىرايلىق	t͡ʃirajliq
چىرايىمۇ	t͡ʃirajimu
چىرايىنى	t͡ʃirajini
چىشلىگەن	t͡ʃiʃliɡɛn
چىشىسىنى	t͡ʃiʃisini
چىقارغان	t͡ʃiqarʁan
چىقالماي	t͡ʃiqalmaj
چىققاندا	t͡ʃiqqanda
چىققانغۇ	t͡ʃiqqanʁu
چىققاچقا	t͡ʃiqqat͡ʃqa
چىقماقچى	t͡ʃiqmaqt͡ʃi
چىقماپتۇ	t͡ʃiqmaptu
چىقىرىدۇ	t͡ʃiqiridu
چىقىرىشى	t͡ʃiqiriʃi
چىقىشىغا	t͡ʃiqiʃiʁa
چىكىلداپ	t͡ʃikildap
چىچەكلەپ	t͡ʃit͡ʃɛklɛp
چۆرىسىدە	t͡ʃørisidɛ
چۆرگىلەپ	t͡ʃørɡilɛp
چۆكتۈرۈپ	t͡ʃøktyryp
چۆلدەرەپ	t͡ʃøldɛrɛp
چۆمۈلگەن	t͡ʃømylɡɛn
چۆپلۈكتە	t͡ʃøplyktɛ
چۆچەكلەر	t͡ʃøt͡ʃɛklɛr
چۇڭۇلداپ	t͡ʃuŋuldap
چۇۋۇلغان	t͡ʃuwulʁan
چۇۋۇلچاق	t͡ʃuwult͡ʃaq
چۈشۈشىنى	t͡ʃyʃyʃini
چۈشەندىم	t͡ʃyʃɛndim
چۈشەنگەن	t͡ʃyʃɛnɡɛn
چېركاۋدا	t͡ʃerkawda
چېچكىنىڭ	t͡ʃet͡ʃkiniŋ
چېچىكىگە	t͡ʃet͡ʃikiɡɛ
چېچىمدىن	t͡ʃet͡ʃimdin
چېچەكلەر	t͡ʃet͡ʃɛklɛr
چەكچىيىپ	t͡ʃɛkt͡ʃijip
چەۋەنداز	t͡ʃɛwɛndaz
گالېننىڭ	ɡalenniŋ
گوركىيغا	ɡorkijʁa
گىدەيگەن	ɡidɛjɡɛn
گىرىپتار	ɡiriptar
گىياھسىز	ɡijahsiz
گىياھلار	ɡijahlar
گۈزەلكەن	ɡyzɛlkɛn
گۈللۈكتە	ɡyllyktɛ
گۈللەرنى	ɡyllɛrni
گۈللەرنڭ	ɡyllɛrnŋ
گۈپۈلدەپ	ɡypyldɛp
گەپلەرنى	ɡɛplɛrni
گەپلەرگە	ɡɛplɛrɡɛ
ھاجەتمەن	had͡ʒɛtmɛn
ھاردۇقۇڭ	harduquŋ
ھارۋىدىن	harwidin
ھارۋىكەش	harwikɛʃ
ھارۋىنىڭ	harwiniŋ
ھازاغىچە	hazaʁit͡ʃɛ
ھازىردىن	hazirdin
ھالقىغان	halqiʁan
ھالىتىنى	halitini
ھاياتلىق	hajatliq
ھاياتىغا	hajatiʁa
ھاياتىنى	hajatini
ھايۋانات	hajwanat
ھايۋاندۇ	hajwandu
ھايۋانغا	hajwanʁa
ھايۋاننى	hajwanni
ھايۋانىي	hajwanij
ھاۋارايى	hawaraji
ھاۋاسىمۇ	hawasimu
ھاۋاسىنى	hawasini
ھوقۇقلۇق	hoquqluq
ھوقۇقىنى	hoquqini
ھىيلىگەر	hijliɡɛr
ھىچكىممۇ	hit͡ʃkimmu
ھۆركىرەپ	hørkirɛp
ھۆكۈمىتى	høkymiti
ھۇششەررە	huʃʃɛrrɛ
ھۇنەرۋەن	hunɛrwɛn
ھېسابىغا	hesabiʁa
ھېساپلاش	hesaplaʃ
ھېسسىيات	hessijat
ھېكايىسى	hekajisi
ھېلىغىچە	heliʁit͡ʃɛ
ھېپوگرات	hepoɡrat
ھېچقانچە	het͡ʃqant͡ʃɛ
ھېچقاچان	het͡ʃqat͡ʃan
ھېچكىمنى	het͡ʃkimni
ھېچكىمگە	het͡ʃkimɡɛ
ھېچنەرسە	het͡ʃnɛrsɛ
ھەببەللى	hɛbbɛlli
ھەددىدىن	hɛddidin
ھەرقايسى	hɛrqajsi
ھەركەتكە	hɛrkɛtkɛ
ھەركەتنى	hɛrkɛtni
ھەرگىزمۇ	hɛrɡizmu
ھەزرەتقۇ	hɛzrɛtqu
ھەسرەتنى	hɛsrɛtni
ھەسەنجان	hɛsɛnd͡ʒan
ھەسەننىڭ	hɛsɛnniŋ
ھەممىمىز	hɛmmimiz
ھەيدەشكە	hɛjdɛʃkɛ
ھەپتىدىن	hɛptidin
ھەپتىدەك	hɛptidɛk
ھەپتىلىك	hɛptilik
ۋادىسىدا	wadisida
ۋارقىردى	warqirdi
ۋارىسلىق	warisliq
ۋاقتىمدا	waqtimda
ۋاقىتتىن	waqittin
ۋاقىتنىڭ	waqitniŋ
ۋوگزالغا	woɡzalʁa
ۋىلىقلاپ	wiliqlap
ۋېتكانىڭ	wetkaniŋ
ۋەدىسىدە	wɛdisidɛ
ۋەزىرلەر	wɛzirlɛr
ۋەزىرنىڭ	wɛzirniŋ
ۋەزىرىمۇ	wɛzirimu
ۋەزىپىگە	wɛzipiɡɛ
ۋەسسالام	wɛssalam
‹‹ئوتتۇز	‹‹ottuz
‹‹سەنئەت	‹‹sɛnɛt
ئىشىكىدە»	iʃikidɛ»
ئۇزاقتىن-ئۇزاق	uzaqtin-uzaq
بىكاردىن-بىكارغا	bikardin-bikarʁa
ۋارقىراپ-جارقىراپ	warqirap-d͡ʒarqirap
ئېكسپورت_قىلىپ	eksport_qilip
تەرەققىي_قىلغان	tɛrɛqqij_qilʁan
ئەھمىيەت_بېرەتتىم	ɛhmijɛt_berɛttim
تەرەققىي_قىلدۇرۇش	tɛrɛqqij_qilduruʃ
تەرەققىي_قىلىۋاتقان	tɛrɛqqij_qiliwatqan
مەركىزىي_تېلىۋىزىيە_خەۋەر_قانىلى	mɛrkizij_teliwizijɛ_χɛwɛr_qanili
مەركىزىي_تېلىۋىزىيە_ئىستانىسى	mɛrkizij_teliwizijɛ_istanisi
ئائىلدىكى	aildiki
ئائىلىلىك	aililik
ئائىلىلەر	aililɛr
ئائىلىنىڭ	ailiniŋ
ئاتامغىلا	atamʁila
ئاتايىتەن	atajitɛn
ئاتكرىتكا	atkritka
ئاتلىرىنى	atlirini
ئاجرىتىدۇ	ad͡ʒritidu
ئاختۇرغان	aχturʁan
ئاخىرلىرى	aχirliri
ئاداققىچە	adaqqit͡ʃɛ
ئادەتتىكى	adɛttiki
ئارالدىكى	araldiki
ئارسىدىكى	arsidiki
ئارقامدىن	arqamdin
ئارقىسىغا	arqisiʁa
ئارىسىدىن	arisidin
ئارىلاپمۇ	arilapmu
ئار–نومۇس	ar–nomus
ئازغاننىڭ	azʁanniŋ
ئاستاغىنە	astaʁinɛ
ئاسترونوم	astronom
ئاستىدىكى	astidiki
ئاسماندىن	asmandin
ئاسماننىڭ	asmanniŋ
ئاشخانىغا	aʃχaniʁa
ئاشقىنىنى	aʃqinini
ئاشكارلاپ	aʃkarlap
ئاشپەزلەر	aʃpɛzlɛr
ئاشۇراتتى	aʃuratti
ئاشۇرۇپتۇ	aʃuruptu
ئاغرىقچان	aʁriqt͡ʃan
ئاغزىمدىن	aʁzimdin
ئاقپىشماق	aqpiʃmaq
ئاكتىپلار	aktiplar
ئالاھازەل	alahazɛl
ئالتەيلەن	altɛjlɛn
ئالدىدىكى	aldidiki
ئالدىمدىن	aldimdin
ئالغاندىن	alʁandin
ئالغانىدى	alʁanidi
ئالغىنىچە	alʁinit͡ʃɛ
ئالماسلىق	almasliq
ئالىيلىرى	alijliri
ئالېكسىىي	aleksiij
ئاماننىسا	amannisa
ئانىسىدىن	anisidin
ئانىسىنىڭ	anisiniŋ
ئانىلارمۇ	anilarmu
ئانىلارنى	anilarni
ئانىڭىزغا	aniŋizʁa
ئاياللىرى	ajalliri
ئايالىنىڭ	ajaliniŋ
ئايرىلدۇق	ajrilduq
ئايرىلغان	ajrilʁan
ئايلانغان	ajlanʁan
ئايلىنىدۇ	ajlinidu
ئايلىنىشى	ajliniʃi
ئايىغىنىڭ	ajiʁiniŋ
ئاپتىپىدا	aptipida
ئاپىرىۋەت	apiriwɛt
ئاپىسىنىڭ	apisiniŋ
ئاچقىنىچە	at͡ʃqinit͡ʃɛ
ئاچلىقتىن	at͡ʃliqtin
ئاچچىقتىن	at͡ʃt͡ʃiqtin
ئاچچىقلاپ	at͡ʃt͡ʃiqlap
ئاڭلىسىلا	aŋlisila
ئاھالىلەر	ahalilɛr
ئوبرازىنى	obrazini
ئوتتۇرىغا	otturiʁa
ئوخشاشتەك	oχʃaʃtɛk
ئوخشايتتى	oχʃajtti
ئوخشايمىز	oχʃajmiz
ئوخشاپراق	oχʃapraq
ئورمانلار	ormanlar
ئورمانلىق	ormanliq
ئورنۇمدىن	ornumdin
ئورىۋالدى	oriwaldi
ئوغلاقنىڭ	oʁlaqniŋ
ئوقلاردەك	oqlardɛk
ئوقۇتقۇچى	oqutqut͡ʃi
ئوقۇيتتۇم	oqujttum
ئولتۇرغان	olturʁan
ئوماقلىقى	omaqliqi
ئويغانغان	ojʁanʁan
ئويلارسىز	ojlarsiz
ئويلاندىم	ojlandim
ئويناقلاپ	ojnaqlap
ئوينايتتى	ojnajtti
ئوينايمىز	ojnajmiz
ئوينايمەن	ojnajmɛn
ئوينىغىلى	ojniʁili
ئويۇنىدىن	ojunidin
ئىبرەتلىك	ibrɛtlik
ئىختىيارى	iχtijari
ئىزدىگىلى	izdiɡili
ئىسسىقراق	issiqraq
ئىسسىقلىق	issiqliq
ئىشخانىدا	iʃχanida
ئىشخانىسى	iʃχanisi
ئىشلىتىدۇ	iʃlitidu
ئىشلىرىدا	iʃlirida
ئىشلىرىغا	iʃliriʁa
ئىشلىرىمۇ	iʃlirimu
ئىشلىرىنى	iʃlirini
ئىشلەتسەم	iʃlɛtsɛm
ئىشلەنگەن	iʃlɛnɡɛn
ئىشلەيتتى	iʃlɛjtti
ئىشىمىزنى	iʃimizni
ئىشىنىسىز	iʃinisiz
ئىشىنىمەن	iʃinimɛn
ئىشەنسىمۇ	iʃɛnsimu
ئىشەنچلىك	iʃɛnt͡ʃlik
ئىشەنگۈسى	iʃɛnɡysi
ئىقتىدارى	iqtidari
ئىقتىسادى	iqtisadi
ئىكراندىن	ikrandin
ئىكرانىدا	ikranida
ئىككىسىنى	ikkisini
ئىككىيلەن	ikkijlɛn
ئىككەيلەن	ikkɛjlɛn
ئىكەنلىكى	ikɛnliki
ئىلاجىسىز	ilad͡ʒisiz
ئىللىقلىق	illiqliq
ئىلىم–پەن	ilim–pɛn
ئىلىۋېلىپ	iliwelip
ئىنتىزامى	intizami
ئىنسانلار	insanlar
ئىنسانلىق	insanliq
ئىنساننىڭ	insanniŋ
ئىنستىتۇت	institut
ئىپادىلەپ	ipadilɛp
ئىچكىرلەپ	it͡ʃkirlɛp
ئۆتكۈزدۈم	øtkyzdym
ئۆتكەندىن	øtkɛndin
ئۆتكەنلەر	øtkɛnlɛr
ئۆتكەنىدى	øtkɛnidi
ئۆتىدىغان	øtidiʁan
ئۆتۇكىنىڭ	øtukiniŋ
ئۆتۈنىمەن	øtynimɛn
ئۆتۈنۈپتۇ	øtynyptu
ئۆتۈنەتتى	øtynɛtti
ئۆردەكتىن	ørdɛktin
ئۆردەكجان	ørdɛkd͡ʒan
ئۆردەكنىڭ	ørdɛkniŋ
ئۆرۈلسىلا	ørylsila
ئۆرۈۋېتىش	ørywetiʃ
ئۆزلىرىنى	øzlirini
ئۆزلىرىگە	øzliriɡɛ
ئۆزىمىزدە	øzimizdɛ
ئۆزىڭىزنى	øziŋizni
ئۆزگىرىشى	øzɡiriʃi
ئۆزۈمنىمۇ	øzymnimu
ئۆلكىسىدە	ølkisidɛ
ئۆيلىرىگە	øjliriɡɛ
ئۆيىمىزگە	øjimizɡɛ
ئۆيىڭىزدە	øjiŋizdɛ
ئۆگزىلىرى	øɡziliri
ئۆگىتەتتى	øɡitɛtti
ئۆگىنىشتە	øɡiniʃtɛ
ئۆگىنىشنى	øɡiniʃni
ئۆگىنىپلا	øɡinipla
ئۆگىنەتتى	øɡinɛtti
ئۇخلاشنىڭ	uχlaʃniŋ
ئۇخلايمەن	uχlajmɛn
ئۇدۇلدىكى	uduldiki
ئۇدۇلۇمغا	udulumʁa
ئۇرغۇتىدۇ	urʁutidu
ئۇرۇلاتتى	urulatti
ئۇرۇنۇپتۇ	urunuptu
ئۇرۇۋەتتى	uruwɛtti
ئۇزاققىچە	uzaqqit͡ʃɛ
ئۇزۇنلۇقى	uzunluqi
ئۇستازنىڭ	ustazniŋ
ئۇستىخىنى	ustiχini
ئۇسسۇزلۇق	ussuzluq
ئۇسىدىغان	usidiʁan
ئۇشتۇمتۇت	uʃtumtut
ئۇنىساقمۇ	unisaqmu
ئۇنىڭدىكى	uniŋdiki
ئۇنچىۋالا	unt͡ʃiwala
ئۇپۇقتىكى	upuqtiki
ئۇچقاندەك	ut͡ʃqandɛk
ئۇچقۇنداپ	ut͡ʃqundap
ئۇچقۇچىسى	ut͡ʃqut͡ʃisi
ئۇچىدىغان	ut͡ʃidiʁan
ئۈرۈمچىدە	yrymt͡ʃidɛ
ئۈزلۈكسىز	yzlyksiz
ئۈستىدىكى	ystidiki
ئۈستىلىگە	ystiliɡɛ
ئۈستىگىچە	ystiɡit͡ʃɛ
ئۈستۋېشىڭ	ystweʃiŋ
ئۈندىمىدى	yndimidi
ئېتىراپقا	etirapqa
ئېتىزغىلا	etizʁila
ئېتىشاتتى	etiʃatti
ئېتىشىپتۇ	etiʃiptu
ئېتىلىپتۇ	etiliptu
ئېتىمىزنى	etimizni
ئېتىۋاپتۇ	etiwaptu
ئېرىشىشكە	eriʃiʃkɛ
ئېرىشىپتۇ	eriʃiptu
ئېرىقتىكى	eriqtiki
ئېرىمغىمۇ	erimʁimu
ئېسىلزادە	esilzadɛ
ئېغىزىدىن	eʁizidin
ئېقىنلىرى	eqinliri
ئېلىمىزگە	elimizɡɛ
ئېلىۋېتىپ	eliwetip
ئېلىۋېلىپ	eliwelip
ئېنىرگىيە	enirɡijɛ
ئېنىقلىقى	eniqliqi
ئېيتقاندا	ejtqanda
ئېيتماقچى	ejtmaqt͡ʃi
ئېيتىشىچە	ejtiʃit͡ʃɛ
ئېيتىلغان	ejtilʁan
ئېچىۋالدى	et͡ʃiwaldi
ئېگىزلىكى	eɡizliki
ئېھتىمالى	ehtimali
ئەتراپنىڭ	ɛtrapniŋ
ئەتراپىدا	ɛtrapida
ئەتلىرىنى	ɛtlirini
ئەتىمىزنى	ɛtimizni
ئەتىيازدا	ɛtijazda
ئەتىگەندە	ɛtiɡɛndɛ
ئەخمىقانە	ɛχmiqanɛ
ئەخمەتجان	ɛχmɛtd͡ʒan
ئەخمەتچان	ɛχmɛtt͡ʃan
ئەركىننىڭ	ɛrkinniŋ
ئەرلىرىنى	ɛrlirini
ئەرلىرىگە	ɛrliriɡɛ
ئەسلىدىغۇ	ɛslidiʁu
ئەسۋابلار	ɛswablar
ئەسۋابىنى	ɛswabini
ئەسەرلىرى	ɛsɛrliri
ئەكەلمىدى	ɛkɛlmidi
ئەللىكلەر	ɛlliklɛr
ئەمىلىمگە	ɛmilimɡɛ
ئەنئەنىۋى	ɛnɛniwi
ئەنگىلىيە	ɛnɡilijɛ
ئەينەكتىن	ɛjnɛktin
ئەينەكنىڭ	ɛjnɛkniŋ
ئەيىبلىدى	ɛjiblidi
ئەپچىللىك	ɛpt͡ʃillik
ئەگلەكتىن	ɛɡlɛktin
ئەھۋالدىن	ɛhwaldin
ئەھۋالىنى	ɛhwalini
ئەۋەتىشتى	ɛwɛtiʃti
ئەۋەتىشنى	ɛwɛtiʃni
ئەۋەتىمەن	ɛwɛtimɛn
ئەۋەتىپتۇ	ɛwɛtiptu
بادىرىلار	badirilar
بارلىقتىن	barliqtin
بارلىقىنى	barliqini
بارىدىغان	baridiʁan
بازاردىكى	bazardiki
بازىرىدىن	baziridin
باسقۇچىدا	basqut͡ʃida
باسىدىكەن	basidikɛn
باشلانغان	baʃlanʁan
باشلانغۇچ	baʃlanʁut͡ʃ
باشلىرىنى	baʃlirini
باغرىدىكى	baʁridiki
باغلارنىڭ	baʁlarniŋ
باغلىرىنى	baʁlirini
باغچىدىكى	baʁt͡ʃidiki
باغچىسىغا	baʁt͡ʃisiʁa
باغۋەنلەر	baʁwɛnlɛr
باقمايتتى	baqmajtti
باكتېرىيە	bakterijɛ
بالاساغۇن	balasaʁun
بالىسىنىڭ	balisiniŋ
بالىلارغا	balilarʁa
بالىلارمۇ	balilarmu
بالىلارنى	balilarni
بالىلىرىم	balilirim
بالىلىرىى	balilirii
بالىمىكەن	balimikɛn
باندىتلار	banditlar
بايلىقتىن	bajliqtin
بايلىقنىڭ	bajliqniŋ
بورسوقنىڭ	borsoqniŋ
بورسۇقجان	borsuqd͡ʒan
بورسۇقنىڭ	borsuqniŋ
بوشلۇقتىن	boʃluqtin
بوشلۇقىدا	boʃluqida
بوشلۇقىغا	boʃluqiʁa
بولاتتىكى	bolattiki
بولالايدۇ	bolalajdu
بولاپكىنى	bolapkini
بولدۇڭلار	bolduŋlar
بولغاندىن	bolʁandin
بولغاندەك	bolʁandɛk
بولغانسەن	bolʁansɛn
بولغانىدى	bolʁanidi
بولغاچقا،	bolʁat͡ʃqa،
بولماستىن	bolmastin
بولمايتتى	bolmajtti
بولمىسىمۇ	bolmisimu
بولىدىغان	bolidiʁan
بولىدىكەن	bolidikɛn
بولىسىلەر	bolisilɛr
بولۇشىدىن	boluʃidin
بولۇشىمىز	boluʃimiz
بولۇشۇپتۇ	boluʃuptu
بىدئەتلىك	bidɛtlik
بىراۋلىرى	birawliri
بىردىنبىر	birdinbir
بىردەمدىن	birdɛmdin
بىردەملىك	birdɛmlik
بىرلەشكەن	birlɛʃkɛn
بىرىنىڭكى	biriniŋki
بىرەرسىنى	birɛrsini
بىلدۇرىدۇ	bilduridu
بىلمەيمىز	bilmɛjmiz
بىلمەيمەن	bilmɛjmɛn
بىلىدىغان	bilidiʁan
بىلىدىكەن	bilidikɛn
بىلىملىرى	bilimliri
بىلىۋېلىش	biliweliʃ
بىلەلەيدۇ	bilɛlɛjdu
بۆرىكەندە	børikɛndɛ
بۆرىكەنغۇ	børikɛnʁu
بۆرىلەرنى	børilɛrni
بۆلەكتىكى	bølɛktiki
بۆلەكچىلا	bølɛkt͡ʃila
بۇرۇتۇمنى	burutumni
بۇرۇلۇپتۇ	buruluptu
بۇقۇلدىشى	buquldiʃi
بۇلارغىمۇ	bularʁimu
بۇنىڭدىكى	buniŋdiki
بۇيرۇيتتى	bujrujtti
بۇيۇملىرى	bujumliri
بېرىدىغان	beridiʁan
بېرىشىمنى	beriʃimni
بېرىلمىسە	berilmisɛ
بېرەلمىدى	berɛlmidi
بېرەلىگەن	berɛliɡɛn
بېرەلەيدۇ	berɛlɛjdu
بېشىمىزغا	beʃimizʁa
بېشىمىزنى	beʃimizni
بېغىشلىدى	beʁiʃlidi
بېغىشىدىن	beʁiʃidin
بېكىتىشتى	bekitiʃti
بېكىتىلدى	bekitildi
بېيجىڭنىڭ	bejd͡ʒiŋniŋ
بەرداشلىق	bɛrdaʃliq
بەرمەستىن	bɛrmɛstin
بەرگەندىن	bɛrɡɛndin
بەللىرىنى	bɛllirini
بەلۋېغىغا	bɛlweʁiʁa
تاتىراڭغۇ	tatiraŋʁu
تاتىلاشقا	tatilaʃqa
تاختايدىن	taχtajdin
تارتماقتا	tartmaqta
تارتمىغان	tartmiʁan
تارتىلغان	tartilʁan
تارقاتقان	tarqatqan
تارىلارنى	tarilarni
تازىلايدۇ	tazilajdu
تازىلىقنى	taziliqni
تاشلىنىدۇ	taʃlinidu
تاغلارنىڭ	taʁlarniŋ
تاللانغان	tallanʁan
تامچىلىرى	tamt͡ʃiliri
تايانچىغا	tajant͡ʃiʁa
تايىنىشتا	tajiniʃta
تايىنىپمۇ	tajinipmu
تايچاقتەك	tajt͡ʃaqtɛk
تاپالمىدى	tapalmidi
توختايتتى	toχtajtti
توختىمىدى	toχtimidi
تورداشلار	tordaʃlar
تورغاريغا	torʁarjʁa
تورغاينىڭ	torʁajniŋ
توزغاقتەك	tozʁaqtɛk
توسىمىدىم	tosimidim
توغرولنىڭ	toʁrolniŋ
توغرىسىدا	toʁrisida
توغرىمىدۇ	toʁrimidu
توغىرسىدا	toʁirsida
توققۇزلار	toqquzlar
توقلۇقىنى	toqluqini
توقۇتايچۇ	toqutajt͡ʃu
توكارېپنى	tokarepni
تولغانىدى	tolʁanidi
تونلىرىنى	tonlirini
توپىسىنىڭ	topisiniŋ
توپىلارنى	topilarni
تىرىشاتتى	tiriʃatti
تىزگىنلەپ	tizɡinlɛp
تىزگىنىنى	tizɡinini
تىكلەنگەن	tiklɛnɡɛn
تىكىلەتتى	tikilɛtti
تىكۋاتقان	tikwatqan
تۆشۈكىدىن	tøʃykidin
تۆھپىلىرى	tøhpiliri
تۆۋەندىكى	tøwɛndiki
تۇتقىنىچە	tutqinit͡ʃɛ
تۇتۇۋېلىپ	tutuwelip
تۇرسۇننىڭ	tursunniŋ
تۇرغاندىن	turʁandin
تۇرغىنىغا	turʁiniʁa
تۇرغىنىنى	turʁinini
تۇرمۇشنىڭ	turmuʃniŋ
تۇرمۇشىنى	turmuʃini
تۇرىدىغان	turidiʁan
تۇرىدىكەن	turidikɛn
تۇرپاننىڭ	turpanniŋ
تۇرۇشاتتى	turuʃatti
تۇرۇشۇمنى	turuʃumni
تۇرۇۋېلىپ	turuwelip
تۇغقاننىڭ	tuʁqanniŋ
تۇقۇغاندۇ	tuquʁandu
تۇيدۇرماي	tujdurmaj
تۇيغۇلىرى	tujʁuliri
تۇيۇلۇپتۇ	tujuluptu
تۇپراقسىز	tupraqsiz
تۈرمەلچەك	tyrmɛlt͡ʃɛk
تۈزۈمىنىڭ	tyzyminiŋ
تۈنۈگۈنكى	tynyɡynki
تۈگمىسىگە	tyɡmisiɡɛ
تېخنىكىسى	teχnikisi
تېزلەتتىم	tezlɛttim
تېشىدىغان	teʃidiʁan
تېكىستلەر	tekistlɛr
تېلېفوندا	telefonda
تېلېفونغا	telefonʁa
تېلېۋىزور	telewizor
تېپىلمىدى	tepilmidi
تەبرىكلەش	tɛbriklɛʃ
تەبىئىيكى	tɛbiijki
تەبىئەتكە	tɛbiɛtkɛ
تەبىئەتنى	tɛbiɛtni
تەجرىبىنى	tɛd͡ʒribini
تەخەللۇسى	tɛχɛllusi
تەربىيلەش	tɛrbijlɛʃ
تەرتىپلىك	tɛrtiplik
تەركىبىدە	tɛrkibidɛ
تەستىقىنى	tɛstiqini
تەسىراتقا	tɛsiratqa
تەسۋىرلەپ	tɛswirlɛp
تەشكىللەپ	tɛʃkillɛp
تەشەببۇسى	tɛʃɛbbusi
تەقەززاسى	tɛqɛzzasi
تەكرارلاپ	tɛkrarlap
تەكىتلىدى	tɛkitlidi
تەييارلاپ	tɛjjarlap
تەييارلاڭ	tɛjjarlaŋ
تەييارلىق	tɛjjarliq
تەڭرىتېغى	tɛŋriteʁi
تەۋرەنمەس	tɛwrɛnmɛs
جازالاشقا	d͡ʒazalaʃqa
جاكارلىدى	d͡ʒakarlidi
جانلىقلىق	d͡ʒanliqliq
جايلارنىڭ	d͡ʒajlarniŋ
جايلاشقان	d͡ʒajlaʃqan
جايلىرىدا	d͡ʒajlirida
جوھراينىڭ	d͡ʒohrajniŋ
جىددىيلىك	d͡ʒiddijlik
جىرىڭلىدى	d͡ʒiriŋlidi
جىلغىسىدا	d͡ʒilʁisida
جىمجىتلىق	d͡ʒimd͡ʒitliq
جىنىسلىرى	d͡ʒinisliri
جۇشقۇنلۇق	d͡ʒuʃqunluq
جۇڭگودىكى	d͡ʒuŋɡodiki
جۈرئەتنىڭ	d͡ʒyrɛtniŋ
جېلىليۈزى	d͡ʒeliljyzi
جەريانىدا	d͡ʒɛrjanida
جەريانىنى	d͡ʒɛrjanini
جەينىكىگە	d͡ʒɛjnikiɡɛ
جەھەتتىكى	d͡ʒɛhɛttiki
خاتىرىلەپ	χatirilɛp
خادىمىدىن	χadimidin
خاراكتېرى	χarakteri
خالتىسىنى	χaltisini
خالىمىدىڭ	χalimidiŋ
خوجايىنىم	χod͡ʒajinim
خوشاللىقى	χoʃalliqi
خوشلاشتۇق	χoʃlaʃtuq
خوشلاشقان	χoʃlaʃqan
خىرەلىشىپ	χirɛliʃip
خىزمىتىنى	χizmitini
خىسلەتلىك	χislɛtlik
خىلۋەتلىك	χilwɛtlik
خىمىچىسكى	χimit͡ʃiski
خىيالىمغا	χijalimʁa
خىيالىمنى	χijalimni
خۇدايىمەي	χudajimɛj
خۇشخۇيلۇق	χuʃχujluq
خۇشپۇرىقى	χuʃpuriqi
خۇلېۋانىڭ	χulewaniŋ
خەزىنىنىڭ	χɛzininiŋ
خەۋەرلىرى	χɛwɛrliri
دادىسىدىن	dadisidin
دادىسىنىڭ	dadisiniŋ
دارۋېننىڭ	darwenniŋ
دالىلارغا	dalilarʁa
دانالىرىڭ	danaliriŋ
دانىسىدەك	danisidɛk
دانچىلىرى	dant͡ʃiliri
داۋالاندى	dawalandi
دوستلىرىم	dostlirim
دوقۇرۇشۇپ	doquruʃup
دولقۇنلار	dolqunlar
دولقۇنلاپ	dolqunlap
دوللىرىغا	dolliriʁa
دىرېكتورى	direktori
دىققىتىنى	diqqitini
دۆڭكۆۋرۈك	døŋkøwryk
دۆۋىسىنىڭ	døwisiniŋ
دۇختۇرلۇق	duχturluq
دۇنيادىكى	dunjadiki
دۇنياسىدا	dunjasida
دۇنياسىغا	dunjasiʁa
دېرىزىدىن	derizidin
دېمىگەندە	demiɡɛndɛ
دېيىشىدىن	dejiʃidin
دېيىشىمنى	dejiʃimni
دېيىشىپتۇ	dejiʃiptu
دېگىنىڭنى	deɡiniŋni
دېگەنىدىڭ	deɡɛnidiŋ
دېھقاندەك	dehqandɛk
دېھقانلار	dehqanlar
دەرىجىلىك	dɛrid͡ʒilik
دەرىخىنىڭ	dɛriχiniŋ
دەرۋازىدا	dɛrwazida
دەرۋازىسى	dɛrwazisi
دەرۋازىغا	dɛrwaziʁa
دەسلىپىدە	dɛslipidɛ
دەۋرىدىكى	dɛwridiki
دەۋېتىپتۇ	dɛwetiptu
راستتىنلا	rasttinla
راسلىنىدۇ	raslinidu
رايوندىكى	rajondiki
رايونلىرى	rajonliri
رايونىمىز	rajonimiz
رايونىنىڭ	rajoniniŋ
رىياسەتچى	rijasɛtt͡ʃi
رەختلەرنى	rɛχtlɛrni
رەستىدىكى	rɛstidiki
رەڭلەردىن	rɛŋlɛrdin
رەڭگىرويى	rɛŋɡiroji
رەھبەرلىك	rɛhbɛrlik
رەھمەتلىك	rɛhmɛtlik
زورلۇقىنى	zorluqini
زىلزىلىگە	zilziliɡɛ
زىيارەتكە	zijarɛtkɛ
زىياۋۇدۇن	zijawudun
زۇمرەتتەك	zumrɛttɛk
زەربىسىگە	zɛrbisiɡɛ
زەنجىرنىڭ	zɛnd͡ʒirniŋ
سائىتىمگە	saitimɡɛ
ساتىدىغان	satidiʁan
ساتىراشقا	satiraʃqa
ساداسىدىن	sadasidin
ساراسىمگە	sarasimɡɛ
ساقاللىرى	saqalliri
ساقايمىدى	saqajmidi
ساقلايمەن	saqlajmɛn
ساقلىنىشى	saqliniʃi
ساقىيىپتۇ	saqijiptu
سالاھيىتى	salahjiti
سالساڭلار	salsaŋlar
سالقىنلىق	salqinliq
سالمىقىنى	salmiqini
ساندۇقىنى	sanduqini
سايلايسىز	sajlajsiz
سايلايمەن	sajlajmɛn
سلوۋېنىيە	slowenijɛ
سورىغاندا	soriʁanda
سومكىسىنى	somkisini
سىرتىدىكى	sirtidiki
سىرلانغان	sirlanʁan
سىزىقىدىن	siziqidin
سىلكىسىمۇ	silkisimu
سۆزلىرىنى	søzlirini
سۆزلەشتىن	søzlɛʃtin
سۆزلەيتتى	søzlɛjtti
سۆيۈشىمىز	søjyʃimiz
سۇغىرىشقا	suʁiriʃqa
سۇنىشىمىز	suniʃimiz
سۇپىسىدىن	supisidin
سۈرئەتتىن	syrɛttin
سۈرئەتلىك	syrɛtlik
سۈرىدىغان	syridiʁan
سۈزۈكلۈكى	syzyklyki
سېتىۋېلىپ	setiwelip
سېزىدىغان	sezidiʁan
سېلىۋىتىپ	seliwitip
سېلىۋېتىپ	seliwetip
سېلىۋەتتى	seliwɛtti
سەدددىچىن	sɛdddit͡ʃin
سەزگۈلىرى	sɛzɡyliri
سەزگەندەك	sɛzɡɛndɛk
سەكرىسىمۇ	sɛkrisimu
سەيلىسىگە	sɛjlisiɡɛ
سەيياھتەك	sɛjjahtɛk
سەپسالدىم	sɛpsaldim
سەۋىيىدىن	sɛwijidin
سەۋەبىدىن	sɛwɛbidin
شاخلىرىدا	ʃaχlirida
شارائىتتا	ʃaraitta
شامىلىنىڭ	ʃamiliniŋ
شاڭخەيدىن	ʃaŋχɛjdin
شىركەتنىڭ	ʃirkɛtniŋ
شىرنىسىنى	ʃirnisini
شىمالدىكى	ʃimaldiki
شۇنچىۋالا	ʃunt͡ʃiwala
شەكلىگىچە	ʃɛkliɡit͡ʃɛ
شەكىلدىكى	ʃɛkildiki
شەكىلىدىن	ʃɛkilidin
شەھىرىنىڭ	ʃɛhiriniŋ
شەھەردىكى	ʃɛhɛrdiki
غالتىكىنى	ʁaltikini
غالجىرانە	ʁald͡ʒiranɛ
غوزەكلىشى	ʁozɛkliʃi
غۇدۇڭشىدى	ʁuduŋʃidi
غەلىتىلىك	ʁɛlitilik
غەيرەتجان	ʁɛjrɛtd͡ʒan
غەيرەتلىك	ʁɛjrɛtlik
قابىلىيەت	qabilijɛt
قاتتىقىنى	qattiqini
قاتناشقان	qatnaʃqan
قاراشتىلا	qaraʃtila
قارىساممۇ	qarisammu
قارىسىڭىز	qarisiŋiz
قارىشىپتۇ	qariʃiptu
قارىشىڭغا	qariʃiŋʁa
قارىغاندا	qariʁanda
قارىغۇدەك	qariʁudɛk
قارىماقتا	qarimaqta
قارىماققا	qarimaqqa
قارىۋالدى	qariwaldi
قارىۋېتىپ	qariwetip
قارىۋەتتى	qariwɛtti
قازانغىلا	qazanʁila
قاقشاتقۇچ	qaqʃatqut͡ʃ
قالدۇرغان	qaldurʁan
قالغاندەك	qalʁandɛk
قالغانىدى	qalʁanidi
قالماسمەن	qalmasmɛn
قالپىقىغا	qalpiqiʁa
قاناتلىرى	qanatliri
قانداشلىق	qandaʃliq
قانداقتۇر	qandaqtur
قايتماقچى	qajtmaqt͡ʃi
قايتىشىدۇ	qajtiʃidu
قايتۇرغان	qajturʁan
قاپتىلىغا	qaptiliʁa
قاپلانغان	qaplanʁan
قاچىلاشقا	qat͡ʃilaʃqa
قاڭشارلىق	qaŋʃarliq
قوتاندىكى	qotandiki
قورسىقىغا	qorsiqiʁa
قورسىقىنى	qorsiqini
قورشالغان	qorʃalʁan
قورشاۋىغا	qorʃawiʁa
قورۇقلىرى	qoruqliri
قورۇمىلار	qorumilar
قوزغالغان	qozʁalʁan
قوزىكەنغۇ	qozikɛnʁu
قوزىچىقىم	qozit͡ʃiqim
قوغدىغىلى	qoʁdiʁili
قوغلاشتىم	qoʁlaʃtim
قوغلىغىلى	qoʁliʁili
قوغۇشۇننى	qoʁuʃunni
قولتۇقلاپ	qoltuqlap
قولتۇقىنى	qoltuqini
قوللىرىدا	qollirida
قوللىرىنى	qollirini
قوللىمىدى	qollimidi
قولىقىمغا	qoliqimʁa
قولىمىزنى	qolimizni
قومارغىلى	qomarʁili
قونچاقلار	qont͡ʃaqlar
قويغانىدى	qojʁanidi
قويلارنىڭ	qojlarniŋ
قويمايتتى	qojmajtti
قوينىدىكى	qojnidiki
قويىۋەتتى	qojiwɛtti
قويۇۋېلىپ	qojuwelip
قوپۇرۇلسا	qopurulsa
قىزدۇرغان	qizdurʁan
قىزلارنىڭ	qizlarniŋ
قىزلىرىغا	qizliriʁa
قىزىقاتتى	qiziqatti
قىزىمىزنى	qizimizni
قىزچاقتەك	qizt͡ʃaqtɛk
قىزچاقنىڭ	qizt͡ʃaqniŋ
قىسىشاتتى	qisiʃatti
قىلالايدۇ	qilalajdu
قىلالمىدى	qilalmidi
قىلالىسۇن	qilalisun
قىلغاندىن	qilʁandin
قىلغايسەن	qilʁajsɛn
قىلماستىن	qilmastin
قىلمىغىنى	qilmiʁini
قىلىدىغان	qilidiʁan
قىلىشاتتى	qiliʃatti
قىلىشنىمۇ	qiliʃnimu
قىلىشىمىز	qiliʃimiz
قىلىشىپتۇ	qiliʃiptu
قىلىۋالدى	qiliwaldi
قىلىۋېتىش	qiliwetiʃ
قىلىۋېتىڭ	qiliwetiŋ
قىلىۋەردى	qiliwɛrdi
قىلۋاتقان	qilwatqan
قىممىتىنى	qimmitini
قىممەتلىك	qimmɛtlik
قىياپەتتە	qijapɛttɛ
قىياپەتكە	qijapɛtkɛ
قىينالغان	qijnalʁan
قۇربىمنىڭ	qurbimniŋ
قۇرۇلمىسى	qurulmisi
قۇرۇمىغان	qurumiʁan
قۇشقاچتەك	quʃqat͡ʃtɛk
قۇشلارنىڭ	quʃlarniŋ
قۇلىقىمغا	quliqimʁa
قۇلۇلىنىڭ	qululiniŋ
قۇياشنىلا	qujaʃnila
قۇيرۇقىدا	qujruqida
قۇيرۇقىغا	qujruqiʁa
قېتىشىپتۇ	qetiʃiptu
قېزىشاتتى	qeziʃatti
قېلىشىدىن	qeliʃidin
قەدىرىيەت	qɛdirijɛt
قەدىمىمنى	qɛdimimni
قەيسەرلىك	qɛjsɛrlik
قەپىسىمدە	qɛpisimdɛ
قەۋىتىدىن	qɛwitidin
قەۋەتلىرى	qɛwɛtliri
كارىۋاتتا	kariwatta
كارۋىتىدا	karwitida
كاللىسىغا	kallisiʁa
كامالەتكە	kamalɛtkɛ
كاۋىلارغا	kawilarʁa
كاۋىلىرىم	kawilirim
كومپيۇتېر	kompjuter
كوچىلارغا	kot͡ʃilarʁa
كىرىدىغان	kiridiʁan
كىرىشىپتۇ	kiriʃiptu
كىرىشەتتى	kiriʃɛtti
كىرىۋالدى	kiriwaldi
كىرىۋاپتۇ	kiriwaptu
كىرىۋېلىپ	kiriwelip
كىرگەندىن	kirɡɛndin
كىرگەندەك	kirɡɛndɛk
كىشىلەردە	kiʃilɛrdɛ
كىشىلەرلا	kiʃilɛrla
كىشىلەرنى	kiʃilɛrni
كىشىلەرگە	kiʃilɛrɡɛ
كىلومېتىر	kilometir
كىملەرنىڭ	kimlɛrniŋ
كىيىدىغان	kijidiʁan
كىيىملىرى	kijimliri
كىيىنىشكە	kijiniʃkɛ
كىيىنىمەن	kijinimɛn
كىيىۋېتىپ	kijiwetip
كىچىككىنە	kit͡ʃikkinɛ
كىچىكىدىن	kit͡ʃikidin
كۆتۈرمىدى	køtyrmidi
كۆتۈرۈشتى	køtyryʃti
كۆتۈرۈشكە	køtyryʃkɛ
كۆتۈرۈشۈپ	køtyryʃyp
كۆتۈرۈلدى	køtyryldi
كۆتۈرۈلۈپ	køtyrylyp
كۆرسىتىشى	kørsitiʃi
كۆرسەتكەن	kørsɛtkɛn
كۆرىدىغان	køridiʁan
كۆرگەندىن	kørɡɛndin
كۆرگەندەك	kørɡɛndɛk
كۆرۈشنىمۇ	køryʃnimu
كۆرۈلۈشكە	kørylyʃkɛ
كۆرۈندىمۇ	køryndimu
كۆرۈنمىدى	kørynmidi
كۆرۈنەتتى	kørynɛtti
كۆرۈۋېتىپ	kørywetip
كۆرەلىدۇق	kørɛliduq
كۆزلىرىدە	køzliridɛ
كۆزلىرىنى	køzlirini
كۆزلىرىگە	køzliriɡɛ
كۆزىڭىزگە	køziŋizɡɛ
كۆلىمىنىڭ	køliminiŋ
كۆمۈلۈپلا	kømylypla
كۆيىنىمەن	køjinimɛn
كۆيۈنۈشنى	køjynyʃni
كۆيۈنەتتى	køjynɛtti
كۆپتۈرگەن	køptyrɡɛn
كۆپىيىشكە	køpijiʃkɛ
كۆپىيەتتى	køpijɛtti
كۆچەتنىمۇ	køt͡ʃɛtnimu
كۆڭلەكنىڭ	køŋlɛkniŋ
كۇلۇبىدىن	kulubidin
كۈتىۋېلىش	kytiweliʃ
كۈتۈۋالدى	kytywaldi
كۈلۈشەتتى	kylyʃɛtti
كۈلۈمسرەپ	kylymsrɛp
كۈنلىرىدە	kynliridɛ
كۈنلىرىنى	kynlirini
كۈنلەرنىڭ	kynlɛrniŋ
كۈچىمەيلا	kyt͡ʃimɛjla
كېتىدىغان	ketidiʁan
كېتىدىكەن	ketidikɛn
كېتىشەتتى	ketiʃɛtti
كېتىۋېتىپ	ketiwetip
كېسىدىكەن	kesidikɛn
كېلىدىغان	kelidiʁan
كېلىدىكەن	kelidikɛn
كېلىشىممۇ	keliʃimmu
كېلىۋىدىم	keliwidim
كېڭىيىپتۇ	keŋijiptu
كەتكىنىنى	kɛtkinini
كەتكىنىگە	kɛtkiniɡɛ
كەتكەندىن	kɛtkɛndin
كەتكەندەك	kɛtkɛndɛk
كەتكەنىدى	kɛtkɛnidi
كەتمەيتتى	kɛtmɛjtti
كەتمەيمىز	kɛtmɛjmiz
كەسكىنلىك	kɛskinlik
كەشپىياتى	kɛʃpijati
كەلتۈرگەن	kɛltyrɡɛn
كەلگەندىن	kɛlɡɛndin
كەلگەندەك	kɛlɡɛndɛk
كەچۈرۈمگە	kɛt͡ʃyrymɡɛ
كەچۈرۈپتۇ	kɛt͡ʃyryptu
لايىھىلەپ	lajihilɛp
لايىھەلەپ	lajihɛlɛp
لاي–لايقا	laj–lajqa
لەززەتلىك	lɛzzɛtlik
لەگلەكلەر	lɛɡlɛklɛr
مابەينىدە	mabɛjnidɛ
مارجاندەك	mard͡ʒandɛk
ماركىسىغا	markisiʁa
ماركىسىنى	markisini
ماركىلىرى	markiliri
ماشىنىدىن	maʃinidin
مايلانغان	majlanʁan
ماڭىدىغان	maŋidiʁan
ماڭىسىلەر	maŋisilɛr
مىجەزىمنى	mid͡ʒɛzimni
مىخلانغان	miχlanʁan
مىقدارىنى	miqdarini
مىللەتلەر	millɛtlɛr
مۆكۈنەتتى	møkynɛtti
مۆلچەرلەش	mølt͡ʃɛrlɛʃ
مۇختەرباي	muχtɛrbaj
مۇدىرىمىز	mudirimiz
مۇدىرىنىڭ	mudiriniŋ
مۇراسىمغا	murasimʁa
مۇزىكىدىن	muzikidin
مۇشتۇمىنى	muʃtumini
مۇشۇنچلىك	muʃunt͡ʃlik
مۇشۇنچىلا	muʃunt͡ʃila
مۇلازىمەت	mulazimɛt
مۇلدۇرلەپ	muldurlɛp
مۇنچاقتەك	munt͡ʃaqtɛk
مۇنۇلارنى	munularni
مۈرىسىنىڭ	myrisiniŋ
مۈكچەيگەن	mykt͡ʃɛjɡɛn
مۈڭگۈزسىز	myŋɡyzsiz
مۈڭگۈزلۈك	myŋɡyzlyk
مېدىتسىنا	meditsina
مېۋىلەرنى	mewilɛrni
مېۋىلەرگە	mewilɛrɡɛ
مەبلىغىدە	mɛbliʁidɛ
مەدرىسىدە	mɛdrisidɛ
مەدەنىيەت	mɛdɛnijɛt
مەزگىللىك	mɛzɡillik
مەزگىلىدە	mɛzɡilidɛ
مەستلىكىم	mɛstlikim
مەسىلسىنى	mɛsilsini
مەسىلىلەر	mɛsililɛr
مەشرەپنىڭ	mɛʃrɛpniŋ
مەشلەرنىڭ	mɛʃlɛrniŋ
مەكتىپى››	mɛktipi››
مەكتەپتىن	mɛktɛptin
مەكتەپنىڭ	mɛktɛpniŋ
مەمنۇنلۇق	mɛmnunluq
مەنزىرلىك	mɛnzirlik
مەنزىرىسى	mɛnzirisi
مەيدانىدا	mɛjdanida
مەيدانىغا	mɛjdaniʁa
مەيدىسىنى	mɛjdisini
مەھسۇلاتى	mɛhsulati
مەھمۇدنىڭ	mɛhmudniŋ
مەھەللىدە	mɛhɛllidɛ
مەھەللىسى	mɛhɛllisi
مەھەللىگە	mɛhɛlliɡɛ
نامراتلار	namratlar
ناھىيىلىك	nahijilik
ناھىيىنىڭ	nahijiniŋ
نوپۇسىنىڭ	nopusiniŋ
نىسبىتىنى	nisbitini
نۆۋەتتىكى	nøwɛttiki
نۇسخىلىرى	nusχiliri
نۇقتىسىدا	nuqtisida
نېرى–بېرى	neri–beri
نېمىدىگەن	nemidiɡɛn
نېمىدېگەن	nemideɡɛn
نېمىشقىمۇ	nemiʃqimu
نېمىلەرنى	nemilɛrni
نېمىنىدۇر	neminidur
نېپىزغىنا	nepizʁina
نېگاتىپنى	neɡatipni
نەشپۈتلەر	nɛʃpytlɛr
نەچچەيلەن	nɛt͡ʃt͡ʃɛjlɛn
نەۋرەمنىڭ	nɛwrɛmniŋ
ياتىسەنغۇ	jatisɛnʁu
ياخشىلىرى	jaχʃiliri
يارىتىلدى	jaritildi
يارىسىنىڭ	jarisiniŋ
يارىشىپتۇ	jariʃiptu
يازغۇچىسى	jazʁut͡ʃisi
ياسىماقچى	jasimaqt͡ʃi
ياسىۋالدى	jasiwaldi
ياشلاردىن	jaʃlardin
ياشلىقىدا	jaʃliqida
ياغىدىكەن	jaʁidikɛn
ياقمىدىغۇ	jaqmidiʁu
يالدامىسى	jaldamisi
يالغاندىن	jalʁandin
يامغۇرلۇق	jamʁurluq
يامغۇرىغا	jamʁuriʁa
يانچۇقىغا	jant͡ʃuqiʁa
يايلاقلار	jajlaqlar
يايلاقنىڭ	jajlaqniŋ
ياڭراتقان	jaŋratqan
يورۇقىدەك	joruqidɛk
يوشۇماقچى	joʃumaqt͡ʃi
يوقلىغىلى	joqliʁili
يوقلۇقتىن	joqluqtin
يوقلۇقىنى	joqluqini
يوللىرىنى	jollirini
يوپۇرمىقى	jopurmiqi
يىراقتىكى	jiraqtiki
يىغلايتتى	jiʁlajtti
يىغىسىدىن	jiʁisidin
يىغىلىپتۇ	jiʁiliptu
يىللاردىن	jillardin
يىللىقىدا	jilliqida
يىگىتۋېشى	jiɡitweʃi
يۆتكەيتتى	jøtkɛjtti
يۆنىلىشتە	jøniliʃtɛ
يۇدىۋالاي	judiwalaj
يۇرتلارغا	jurtlarʁa
يۇشۇرۇنچە	juʃurunt͡ʃɛ
يۇقىرىدىن	juqiridin
يۇقىرىنىڭ	juqiriniŋ
يۇلتۇزلار	jultuzlar
يۇلتۇزنىڭ	jultuzniŋ
يۇلىۋېتىپ	juliwetip
يۇلۇۋالدى	juluwaldi
يۇمشىقىنى	jumʃiqini
يۇيۇنغىلى	jujunʁili
يۈرىدىغان	jyridiʁan
يۈرىسىلەر	jyrisilɛr
يۈرۈشەتتى	jyryʃɛtti
يۈزلۈكتەك	jyzlyktɛk
يۈزىمىزنى	jyzimizni
يۈگۈرمىدى	jyɡyrmidi
يۈگۈرۈشۈپ	jyɡyryʃyp
يۈگۈرۈپتۇ	jyɡyryptu
يېتىدىغان	jetidiʁan
يېتىشىدىن	jetiʃidin
يېتىلەشكە	jetilɛʃkɛ
يېتىمكەنا	jetimkɛna
يېتىۋالاي	jetiwalaj
يېتىۋېرىپ	jetiwerip
يېتەكچىسى	jetɛkt͡ʃisi
يېتەلىسۇن	jetɛlisun
يېرىمغىچە	jerimʁit͡ʃɛ
يېزىمىزنڭ	jezimiznŋ
يېغىۋالدى	jeʁiwaldi
يېنىمدىكى	jenimdiki
يېنىمىزدا	jenimizda
يېنىمىزغا	jenimizʁa
يېڭىلىشىپ	jeŋiliʃip
يېگىتۋېشى	jeɡitweʃi
يەتكەندەك	jɛtkɛndɛk
يەتمىگىچە	jɛtmiɡit͡ʃɛ
يەڭگۈشلەپ	jɛŋɡyʃlɛp
پائالىيەت	paalijɛt
پاتنېنتنى	patnentni
پادىشاھقا	padiʃahqa
پادىشاھنى	padiʃahni
پاراققىدە	paraqqidɛ
پارلامېنت	parlament
پارچىسىنى	part͡ʃisini
پارچىلىرى	part͡ʃiliri
پاك–پاكىز	pak–pakiz
پالۋاننىڭ	palwanniŋ
پايتەختتە	pajtɛχttɛ
پايتەختكە	pajtɛχtkɛ
پايدىلنىپ	pajdilnip
پروگرامما	proɡramma
پىشۇراتتى	piʃuratti
پىكىرلىرى	pikirliri
پىلتىڭلاپ	piltiŋlap
پىيادىلەر	pijadilɛr
پۇتلىرىنى	putlirini
پۇرسىتىنى	pursitini
پۇرسىتىگە	pursitiɡɛ
پۇرسەتتىن	pursɛttin
پۇرىماقتا	purimaqta
پۈركەنگەن	pyrkɛnɡɛn
پەرۋىشكار	pɛrwiʃkar
پەزىلەتنى	pɛzilɛtni
پەسىيىشكە	pɛsijiʃkɛ
چارىلەرنى	t͡ʃarilɛrni
چاققانلىق	t͡ʃaqqanliq
چاقنايتتى	t͡ʃaqnajtti
چانىقىدىن	t͡ʃaniqidin
چايلىرىنى	t͡ʃajlirini
چاپانلىرى	t͡ʃapanliri
چاپىنىنىڭ	t͡ʃapininiŋ
چوققىسىغا	t͡ʃoqqisiʁa
چوققىلىرى	t͡ʃoqqiliri
چوكىلارنى	t͡ʃokilarni
چوڭمىكىنە	t͡ʃoŋmikinɛ
چىدىسىڭىز	t͡ʃidisiŋiz
چىرايىدىن	t͡ʃirajidin
چىرايىڭىز	t͡ʃirajiŋiz
چىركاۋنىڭ	t͡ʃirkawniŋ
چىقارسىلا	t͡ʃiqarsila
چىقارغىلى	t͡ʃiqarʁili
چىقالمىدى	t͡ʃiqalmidi
چىققاندىن	t͡ʃiqqandin
چىققىنىغا	t͡ʃiqqiniʁa
چىقىدىكەن	t͡ʃiqidikɛn
چىقىراتتى	t͡ʃiqiratti
چىقىرىشقا	t͡ʃiqiriʃqa
چىقىرىپتۇ	t͡ʃiqiriptu
چىقىۋېتىپ	t͡ʃiqiwetip
چىللىغىچە	t͡ʃilliʁit͡ʃɛ
چىنىسىنىڭ	t͡ʃinisiniŋ
چۆرىدىگەن	t͡ʃøridiɡɛn
چۆمگەنىدى	t͡ʃømɡɛnidi
چۆپلۈكتىن	t͡ʃøplyktin
چۆچەكتىكى	t͡ʃøt͡ʃɛktiki
چۆگىلەشكە	t͡ʃøɡilɛʃkɛ
چۈشكىنىنى	t͡ʃyʃkinini
چۈشكۈرگەن	t͡ʃyʃkyrɡɛn
چۈشىدىغان	t͡ʃyʃidiʁan
چۈشىنىمەن	t͡ʃyʃinimɛn
چۈشىنەتتى	t͡ʃyʃinɛtti
چۈشۈرگىلى	t͡ʃyʃyrɡili
چۈشۈرۈپتۇ	t͡ʃyʃyryptu
چۈشۈرەتتى	t͡ʃyʃyrɛtti
چۈشۈۋېتىپ	t͡ʃyʃywetip
چۈشەندىكى	t͡ʃyʃɛndiki
چېركاۋنىڭ	t͡ʃerkawniŋ
چېلىكىمنى	t͡ʃelikimni
چېلىكىمىز	t͡ʃelikimiz
چېلىكىمگە	t͡ʃelikimɡɛ
چېنىقىشقا	t͡ʃeniqiʃqa
چېچىكىنىڭ	t͡ʃet͡ʃikiniŋ
چەۋەندىزى	t͡ʃɛwɛndizi
ژورنالنىڭ	ʒornalniŋ
گالىلېينى	ɡalilejni
گوركىينىڭ	ɡorkijniŋ
گىرۋىكىدە	ɡirwikidɛ
گۇلتاجىغا	ɡultad͡ʒiʁa
گۇۋاھنامە	ɡuwahnamɛ
گۈرجەكلەر	ɡyrd͡ʒɛklɛr
گۈزىلىدەك	ɡyzilidɛk
گۈزەللىكى	ɡyzɛlliki
گۈلدۈرلەپ	ɡyldyrlɛp
گۈللىرىنى	ɡyllirini
گۈللەردىن	ɡyllɛrdin
گۈللەرنىڭ	ɡyllɛrniŋ
گۈپۈلدىسە	ɡypyldisɛ
ھاجىتىڭنى	had͡ʒitiŋni
ھارغىنلىق	harʁinliq
ھارۋىدىكى	harwidiki
ھارۋىسىغا	harwisiʁa
ھارۋىسىنى	harwisini
ھارۋىلىرى	harwiliri
ھازىرغىچە	hazirʁit͡ʃɛ
ھايتىدىكى	hajtidiki
ھايۋانلار	hajwanlar
ھويلىدىكى	hojlidiki
ھويلىسىدا	hojlisida
ھۆرمەتلىك	hørmɛtlik
ھېكايىسنى	hekajisni
ھېكايىنىڭ	hekajiniŋ
ھېچقانداق	het͡ʃqandaq
ھېچنېمىنى	het͡ʃnemini
ھېچنېمىگە	het͡ʃnemiɡɛ
ھەربىرىگە	hɛrbiriɡɛ
ھەرقانداق	hɛrqandaq
ھەركىتىنى	hɛrkitini
ھەركىمنىڭ	hɛrkimniŋ
ھەرىدەپتۇ	hɛridɛptu
ھەرپلەرنى	hɛrplɛrni
ھەققىدىكى	hɛqqidiki
ھەقىقەتنى	hɛqiqɛtni
ھەقىقەتەن	hɛqiqɛtɛn
ھەممىسىنى	hɛmmisini
ھەممىڭلار	hɛmmiŋlar
ھەممەيلەن	hɛmmɛjlɛn
ھەيدەشتىن	hɛjdɛʃtin
ھەيۋەتلىك	hɛjwɛtlik
ھەپتىگىچە	hɛptiɡit͡ʃɛ
ھەپىلىشىپ	hɛpiliʃip
ۋاراقلىرى	waraqliri
ۋارقىرىدى	warqiridi
ۋاشىنگتون	waʃinɡton
ۋاقتىدىلا	waqtidila
ۋاكولىنكو	wakolinko
ۋالىرىئان	walirian
ۋوگزالنىڭ	woɡzalniŋ
ۋوگزالىدا	woɡzalida
ۋىجدانلىق	wid͡ʒdanliq
ۋېلىسىپىت	welisipit
ۋەتىنىمىز	wɛtinimiz
ۋەھىمىلىك	wɛhimilik
ئائىلىدىكى	ailidiki
ئاتلىرىنىڭ	atliriniŋ
ئاتىغىنىغا	atiʁiniʁa
ئاجرىتىشقا	ad͡ʒritiʃqa
ئاجىزلارنى	ad͡ʒizlarni
ئاجىزلىقنى	ad͡ʒizliqni
ئاختۇرۇشقا	aχturuʃqa
ئاخشاملىرى	aχʃamliri
ئاخىرلاشتى	aχirlaʃti
ئاخىرىدىكى	aχiridiki
ئاخىرىغىچە	aχiriʁit͡ʃɛ
ئادىمىيلىك	adimijlik
ئادەملەرمۇ	adɛmlɛrmu
ئادەملەرنى	adɛmlɛrni
ئادەملەرگە	adɛmlɛrɡɛ
ئاراڭلاردا	araŋlarda
ئارزۇيىمىز	arzujimiz
ئارزۇيۇمغا	arzujumʁa
ئارزۇيۇڭغا	arzujuŋʁa
ئارستوتېلى	arstoteli
ئارغۇبۇلاق	arʁubulaq
ئارقىدىنلا	arqidinla
ئارمىيىنىڭ	armijiniŋ
ئارىستوتېل	aristotel
ئارىلاشقان	arilaʃqan
ئاسانلىقچە	asanliqt͡ʃɛ
ئاستىلىتىپ	astilitip
ئاسمىنىدىن	asminidin
ئاشكارلىدى	aʃkarlidi
ئاشۇرۇشىغا	aʃuruʃiʁa
ئاكىلىقتىن	akiliqtin
ئالالايمىز	alalajmiz
ئالدامچىغا	aldamt͡ʃiʁa
ئالدىرىتىپ	aldiritip
ئالدىمدىكى	aldimdiki
ئالدىمىزدا	aldimizda
ئالدۇرغۇچى	aldurʁut͡ʃi
ئاللىبۇرۇن	alliburun
ئالمىشىپتۇ	almiʃiptu
ئالمىغاندا	almiʁanda
ئالمىلارنى	almilarni
ئالىقىنىغا	aliqiniʁa
ئالىملارمۇ	alimlarmu
ئالەمشۇمۇل	alɛmʃumul
ئامراقلىقى	amraqliqi
ئاناڭلارنى	anaŋlarni
ئانىلارنىڭ	anilarniŋ
ئانىلىرىمۇ	anilirimu
ئانىلىرىنڭ	anilirinŋ
ئانىمىزنىڭ	animizniŋ
ئاياللارغا	ajallarʁa
ئاياللارنى	ajallarni
ئايالىمنىڭ	ajalimniŋ
ئايروپىلان	ajropilan
ئايلىرىنىڭ	ajliriniŋ
ئايلىنىشقا	ajliniʃqa
ئايلىنىمەن	ajlinimɛn
ئايلىنىپتۇ	ajliniptu
ئايلىنىپمۇ	ajlinipmu
ئاپتوبۇسقا	aptobusqa
ئاپتوبۇسنى	aptobusni
ئاپپاراتنى	apparatni
ئاچىمىقىدا	at͡ʃimiqida
ئاچچىقىمدا	at͡ʃt͡ʃiqimda
ئاچچىقىممۇ	at͡ʃt͡ʃiqimmu
ئاڭلىشىمچە	aŋliʃimt͡ʃɛ
ئاڭلىغاندا	aŋliʁanda
ئاڭلىماقتا	aŋlimaqta
ئاڭلىمىدىم	aŋlimidim
ئاۋازلارنى	awazlarni
ئاۋغۇستنىڭ	awʁustniŋ
ئشلىتىشىكە	eʃlitiʃikɛ
ئوبدانغىنە	obdanʁinɛ
ئوتتۇرانچى	otturant͡ʃi
ئوتتۇرسىدا	ottursida
ئوتۇنچىلىق	otunt͡ʃiliq
ئوخشاشلىقى	oχʃaʃliqi
ئوخشىمامدۇ	oχʃimamdu
ئوخشىمىغان	oχʃimiʁan
ئورماندىكى	ormandiki
ئورناتقىلى	ornatqili
ئورۇندايدۇ	orundajdu
ئورۇندۇقتا	orunduqta
ئورۇندۇقنى	orunduqni
ئورۇنلارغا	orunlarʁa
ئورۇنلاشتى	orunlaʃti
ئورۇنلىشىش	orunliʃiʃ
ئوغلىمىزنى	oʁlimizni
ئوغۇللارغا	oʁullarʁa
ئوغۇللارمۇ	oʁullarmu
ئوقۇساڭلار	oqusaŋlar
ئوقۇغاندىن	oquʁandin
ئوقۇغۇچىسى	oquʁut͡ʃisi
ئوقۇغۇچىنى	oquʁut͡ʃini
ئوقۇيدىغان	oqujdiʁan
ئوقۇۋاتقان	oquwatqan
ئوكياندىكى	okjandiki
ئولتۇراتتى	olturatti
ئولتۇرۇشتى	olturuʃti
ئولتۇرۇشقا	olturuʃqa
ئولتۇرۇپتۇ	olturuptu
ئومۇملىشىش	omumliʃiʃ
ئويغىنىپلا	ojʁinipla
ئويلىمىغان	ojlimiʁan
ئويلىنىشقا	ojliniʃqa
ئويمانلىقى	ojmanliqi
ئوينايلىچۇ	ojnajlit͡ʃu
ئوينىشاتتى	ojniʃatti
ئوينىغاندا	ojniʁanda
ئوڭشىۋېلىپ	oŋʃiwelip
ئىتتىرىشىپ	ittiriʃip
ئىجتىمائىي	id͡ʒtimaij
ئىدارىدىكى	idaridiki
ئىستاكاندا	istakanda
ئىستاكاننى	istakanni
ئىستىراھەت	istirahɛt
ئىسسىتىشقا	issitiʃqa
ئىسسىقلىقى	issiqliqi
ئىسسىنىشقا	issiniʃqa
ئىشكابىدىن	iʃkabidin
ئىشلارنىمۇ	iʃlarnimu
ئىشلىتىشكە	iʃlitiʃkɛ
ئىشلىرىنىڭ	iʃliriniŋ
ئىشلەتكىلى	iʃlɛtkili
ئىشىمىزنىڭ	iʃimizniŋ
ئىشەنسىڭىز	iʃɛnsiŋiz
ئىشەنمىگەن	iʃɛnmiɡɛn
ئىشەنگۈڭىز	iʃɛnɡyŋiz
ئىقتىدارىم	iqtidarim
ئىقتىسادىي	iqtisadij
ئىككىسىنىڭ	ikkisiniŋ
ئىككىلىمىز	ikkilimiz
ئىكەنلكىنى	ikɛnlkini
ئىللىقلىقى	illiqliqi
ئىلگىرىلەپ	ilɡirilɛp
ئىلھامبەخش	ilhambɛχʃ
ئىنجىلدىكى	ind͡ʒildiki
ئىنسانىيەت	insanijɛt
ئىنچىكىلەپ	int͡ʃikilɛp
ئىپادىسىدە	ipadisidɛ
ئىپتىدائىي	iptidaij
ئىچكىرىلەپ	it͡ʃkirilɛp
ئىچىۋالغان	it͡ʃiwalʁan
ئىگىلىكىدە	iɡilikidɛ
ئۆتكۈزىمەن	øtkyzimɛn
ئۆتكۈزۈشتە	øtkyzyʃtɛ
ئۆتكۈزۈلۈش	øtkyzylyʃ
ئۆتكۈزۈپتۇ	øtkyzyptu
ئۆتكەنلىكى	øtkɛnliki
ئۆتكەنىدىڭ	øtkɛnidiŋ
ئۆتكەنىكەن	øtkɛnikɛn
ئۆتمىتۆشۈك	øtmitøʃyk
ئۆزلىرىنىڭ	øzliriniŋ
ئۆزىمىزدىن	øzimizdin
ئۆزگىرىپتۇ	øzɡiriptu
ئۆزگىرەتتى	øzɡirɛtti
ئۆز–ئۆزىنى	øz–øzini
ئۆستۈرۈشكە	østyryʃkɛ
ئۆستۈرۈلسە	østyrylsɛ
ئۆلكىلەرگە	ølkilɛrɡɛ
ئۆمۈرۋايەت	ømyrwajɛt
ئۆمۈچۈكنىڭ	ømyt͡ʃykniŋ
ئۆيلىرىنىڭ	øjliriniŋ
ئۆچۈرگۈچنى	øt͡ʃyrɡyt͡ʃni
ئۆگزىسىنىڭ	øɡzisiniŋ
ئۆگىنىشنىڭ	øɡiniʃniŋ
ئۆگىنىشىگە	øɡiniʃiɡɛ
ئۆگىنەلمەي	øɡinɛlmɛj
ئۇرۇشمايلى	uruʃmajli
ئۇزاتماقچى	uzatmaqt͡ʃi
ئۇزارغانچە	uzarʁant͡ʃɛ
ئۇستازىنىڭ	ustaziniŋ
ئۇسۇلۇڭلار	usuluŋlar
ئۇنىۋېرسال	uniwersal
ئۇنۇتمايلى	unutmajli
ئۇيۇشمسىنڭ	ujuʃmsinŋ
ئۇچارقانات	ut͡ʃarqanat
ئۇچالىغىنى	ut͡ʃaliʁini
ئۇچرىغاندا	ut͡ʃriʁanda
ئۇچىسىدىكى	ut͡ʃisidiki
ئۇچۇرلارنى	ut͡ʃurlarni
ئۈرۈمچىنىڭ	yrymt͡ʃiniŋ
ئۈزدۈرۈشكە	yzdyryʃkɛ
ئۈزۈملەرنى	yzymlɛrni
ئۈزۈملەرگە	yzymlɛrɡɛ
ئۈزەلمىدىم	yzɛlmidim
ئۈن–تۈنسىز	yn–tynsiz
ئۈچەيلەننى	yt͡ʃɛjlɛnni
ئېتىزلارغا	etizlarʁa
ئېتىزلارنى	etizlarni
ئېتىزلىققا	etizliqqa
ئېتىشلارغا	etiʃlarʁa
ئېتىقادنىڭ	etiqadniŋ
ئېتىقادىغا	etiqadiʁa
ئېتىۋالدىم	etiwaldim
ئېتەلەيمەن	etɛlɛjmɛn
ئېرىقلاردا	eriqlarda
ئېسىڭلاردا	esiŋlarda
ئېشىندىنىڭ	eʃindiniŋ
ئېغىرلىشىپ	eʁirliʃip
ئېقىۋاتقان	eqiwatqan
ئېلىمىزنىڭ	elimizniŋ
ئېلىنمىغان	elinmiʁan
ئېلىۋەتتىم	eliwɛttim
ئېلېكتىرون	elektiron
ئېيتقىنىچە	ejtqinit͡ʃɛ
ئېيتىشىپتۇ	ejtiʃiptu
ئېيىتماقچى	ejitmaqt͡ʃi
ئېپقالسىلا	epqalsila
ئېچىنىشلىق	et͡ʃiniʃliq
ئەتراپتىكى	ɛtraptiki
ئەتراپىڭغا	ɛtrapiŋʁa
ئەترەتتىكى	ɛtrɛttiki
ئەتىراپىدا	ɛtirapida
ئەتىيازلىق	ɛtijazliq
ئەتىيازنىڭ	ɛtijazniŋ
ئەتىگەندىن	ɛtiɡɛndin
ئەتىۋارلىق	ɛtiwarliq
ئەركىلىتىپ	ɛrkilitip
ئەزىمەتلەر	ɛzimɛtlɛr
ئەستايىدىل	ɛstajidil
ئەسكەرتتىم	ɛskɛrttim
ئەسەبلىرىم	ɛsɛblirim
ئەكىلىشىگە	ɛkiliʃiɡɛ
ئەمگىكىدىن	ɛmɡikidin
ئەمەلدارنى	ɛmɛldarni
ئەنسىرەيدۇ	ɛnsirɛjdu
ئەنگىليىگە	ɛnɡiljiɡɛ
ئەيىبلەشكە	ɛjiblɛʃkɛ
ئەيىبلەيدۇ	ɛjiblɛjdu
ئەگەشتۈرۈپ	ɛɡɛʃtyryp
باتارېيىنى	batarejini
بارخانلىرى	barχanliri
بارغانسېرى	barʁanseri
بارغىنىمنى	barʁinimni
باسالمايلا	basalmajla
باشقىلارغا	baʃqilarʁa
باشقىلارنى	baʃqilarni
باشقۇرغۇچى	baʃqurʁut͡ʃi
باشلانغىچە	baʃlanʁit͡ʃɛ
باشلىتىپتۇ	baʃlitiptu
باشلىرىمنى	baʃlirimni
باشلىقىنىڭ	baʃliqiniŋ
باشلىنىپتۇ	baʃliniptu
باشلىۋەتتى	baʃliwɛtti
باقمايلىمۇ	baqmajlimu
بالىجانلىق	balid͡ʒanliq
بالىلاردىن	balilardin
بالىلاردەك	balilardɛk
بالىلارنىڭ	balilarniŋ
بالىلىرىغا	baliliriʁa
بالىلىرىنى	balilirini
بوشلۇقتىكى	boʃluqtiki
بولالايسىز	bolalajsiz
بولالمايدۇ	bolalmajdu
بولالمىدىم	bolalmidim
بولالمىغان	bolalmiʁan
بولدىڭىزمۇ	boldiŋizmu
بولغانلىقى	bolʁanliqi
بولغانىكەن	bolʁanikɛn
بولغاچقىلا	bolʁat͡ʃqila
بولغىنىدەك	bolʁinidɛk
بولغۇچىدىن	bolʁut͡ʃidin
بولغۇچىنىڭ	bolʁut͡ʃiniŋ
بولكىلارنى	bolkilarni
بولمىغاچقا	bolmiʁat͡ʃqa
بولمىغۇدەك	bolmiʁudɛk
بولىۋاتىدۇ	boliwatidu
بولۇشقاندۇ	boluʃqandu
بولۇۋاتقان	boluwatqan
بويسۇنۇشقا	bojsunuʃqa
بىر–بىرىنى	bir–birini
بىر–بىرىگە	bir–biriɡɛ
بىزنىڭكىگە	bizniŋkiɡɛ
بىشەملىكنى	biʃɛmlikni
بىلدۈرۈپتۇ	bildyryptu
بىلىمىگىمۇ	bilimiɡimu
بىلىندىڭىز	bilindiŋiz
بىلگەنىكەن	bilɡɛnikɛn
بىلەلمەيدۇ	bilɛlmɛjdu
بىلەلەيسىز	bilɛlɛjsiz
بىلەلەيسەن	bilɛlɛjsɛn
بىلەلەيمىز	bilɛlɛjmiz
بىلەمسىلەر	bilɛmsilɛr
بۇرجىكىدىن	burd͡ʒikidin
بۇرۇتۇمنىڭ	burutumniŋ
بۇرۇلۇۋىدى	buruluwidi
بۇرۇنقىدەك	burunqidɛk
بۇرۇنىسىدا	burunisida
بۇلغىمايدۇ	bulʁimajdu
بۇلۇتلارغا	bulutlarʁa
بۇنىڭدىنمۇ	buniŋdinmu
بۇيۇملارغا	bujumlarʁa
بۈگۈنكىدەك	byɡynkidɛk
بېدىلەردىن	bedilɛrdin
بېرىپتىمەن	beriptimɛn
بېرىۋەتسەك	beriwɛtsɛk
بېرىۋەتسەم	beriwɛtsɛm
بېرىۋەتكەن	beriwɛtkɛn
بېرەلمىدىم	berɛlmidim
بېرەلەيسەن	berɛlɛjsɛn
بېرەلەيمەن	berɛlɛjmɛn
بېرەمدىكىن	berɛmdikin
بېزەيدىغان	bezɛjdiʁan
بېسىقتۇرۇش	besiqturuʃ
بېكىتىلىدۇ	bekitilidu
بېكىتىلگەن	bekitilɡɛn
بەرمەكتىدى	bɛrmɛktidi
بەرگلىرىدە	bɛrɡliridɛ
بەرگەنمىدۇ	bɛrɡɛnmidu
بەرگەنىكەن	bɛrɡɛnikɛn
بەلگىلەپتۇ	bɛlɡilɛptu
تاجاۋۇزىغا	tad͡ʒawuziʁa
تارتىشىشقا	tartiʃiʃqa
تارتىۋېلىپ	tartiwelip
تارقىتىپتۇ	tarqitiptu
تارقىلاتتى	tarqilatti
تارقىلىپتۇ	tarqiliptu
تارماقلىرى	tarmaqliri
تاشلارغىچە	taʃlarʁit͡ʃɛ
تاشلايتتۇق	taʃlajttuq
تاشلىۋەتتى	taʃliwɛtti
تاللىماقچى	tallimaqt͡ʃi
تاموژنىدىن	tamoʒnidin
تامچىلارغا	tamt͡ʃilarʁa
تامچىلاشقا	tamt͡ʃilaʃqa
تانكىچىلار	tankit͡ʃilar
تاپالماپتۇ	tapalmaptu
تاپالمىدىم	tapalmidim
توختىتىشقا	toχtitiʃqa
توختىتىشنى	toχtitiʃni
توغرۇلغىمۇ	toʁrulʁimu
تونۇشتۇرۇپ	tonuʃturup
تونۇۋالدۇق	tonuwalduq
توۋلىۋەتتى	towliwɛtti
تىرامۋايغا	tiramwajʁa
تىرىكچىلىك	tirikt͡ʃilik
تىرىڭشىتسا	tiriŋʃitsa
تىرىگىنىچە	tiriɡinit͡ʃɛ
تىلغىۋەتتى	tilʁiwɛtti
تىللىشاتتى	tilliʃatti
تىللىمىغان	tillimiʁan
تىمىسقىلاپ	timisqilap
تىپىرلىشىپ	tipirliʃip
تۆشۈكلەرلا	tøʃyklɛrla
تۆشۈكچىلەر	tøʃykt͡ʃilɛr
تۆكۈلمەيدۇ	tøkylmɛjdu
تۆھپىسىدۇر	tøhpisidur
تۇتۇلۇشىنى	tutuluʃini
تۇتۇۋالغان	tutuwalʁan
تۇرالامسەن	turalamsɛn
تۇرالمىساڭ	turalmisaŋ
تۇرغانىدىم	turʁanidim
تۇرغۇزايلى	turʁuzajli
تۇرمۇشتىكى	turmuʃtiki
تۇرىدىغىنى	turidiʁini
تۇرۇۋاتقان	turuwatqan
تۇيغۇلاردا	tujʁularda
تۈرتكىسىدە	tyrtkisidɛ
تۈركۈمدىكى	tyrkymdiki
تۈمەنلىگەن	tymɛnliɡɛn
تېرىلغاندا	terilʁanda
تېرەكلەرگە	terɛklɛrɡɛ
تېپىۋالدۇق	tepiwalduq
تەبرىكلىدى	tɛbriklidi
تەبىئەتنىڭ	tɛbiɛtniŋ
تەتقىقاتقا	tɛtqiqatqa
تەرىپىدىكى	tɛripidiki
تەرەققىيات	tɛrɛqqijat
تەسەۋۇرىنى	tɛsɛwurini
تەقدىردىمۇ	tɛqdirdimu
تەكشۈرۈشكە	tɛkʃyryʃkɛ
تەلىماتىنى	tɛlimatini
تەلۋىلىشىپ	tɛlwiliʃip
تەنتەربىيە	tɛntɛrbijɛ
تەيىنلەپتۇ	tɛjinlɛptu
تەييارلىقى	tɛjjarliqi
تەڭرىتاغدا	tɛŋritaʁda
جاراھەتتىن	d͡ʒarahɛttin
جاكارلاپتۇ	d͡ʒakarlaptu
جالاقلىتىپ	d͡ʒalaqlitip
جايلاردىكى	d͡ʒajlardiki
جىلغىلارنى	d͡ʒilʁilarni
جىگدىلەرنى	d͡ʒiɡdilɛrni
جەبىرلەرنى	d͡ʒɛbirlɛrni
جەينىكىمگە	d͡ʒɛjnikimɡɛ
جەھەتلەردە	d͡ʒɛhɛtlɛrdɛ
جەۋھەرلىرى	d͡ʒɛwhɛrliri
خاتالاشقان	χatalaʃqan
خاتىرىسىگە	χatirisiɡɛ
خادىملارنى	χadimlarni
خاكوداتېدا	χakodateda
خانىمنىڭمۇ	χanimniŋmu
خانۇۋەيران	χanuwɛjran
خرۇستالدەك	χrustaldɛk
خوككايدوغا	χokkajdoʁa
خىرەلەشكەن	χirɛlɛʃkɛn
خىزمىتىدىن	χizmitidin
خىزمىتىمگە	χizmitimɡɛ
خىزمەتچىسى	χizmɛtt͡ʃisi
خىلۋەتلىكى	χilwɛtliki
خىياللارغا	χijallarʁa
خىياللارنى	χijallarni
خۇشلۇقۇمدا	χuʃluqumda
خەلقئارانى	χɛlqarani
خەلقپەرۋەر	χɛlqpɛrwɛr
دائىرسىنىڭ	dairsiniŋ
داراڭلىغان	daraŋliʁan
دارىلتامغا	dariltamʁa
دانىلىرىنى	danilirini
داۋاملاشتى	dawamlaʃti
داۋاملىشىپ	dawamliʃip
دوستلۇقىنى	dostluqini
دىققىتىمنى	diqqitimni
دىققىتىڭنى	diqqitiŋni
دۇدۇقلىماي	duduqlimaj
دۇنياسىدىن	dunjasidin
دۇنياسىنىڭ	dunjasiniŋ
دۈپۈلدىگەن	dypyldiɡɛn
دېرىمىزنىڭ	derimizniŋ
دېققىتىمنى	deqqitimni
دېيىشمەيلا	dejiʃmɛjla
دېيىلىشىچە	dejiliʃit͡ʃɛ
دېيەلەيسىز	dejɛlɛjsiz
دېڭىزلاردا	deŋizlarda
دېگەنلىرىڭ	deɡɛnliriŋ
دېگەنلەرنى	deɡɛnlɛrni
دەريالاردا	dɛrjalarda
دەرۋازىدىن	dɛrwazidin
دەرۋازىنىڭ	dɛrwaziniŋ
دەرەخلىكنى	dɛrɛχlikni
دەرەخلەردە	dɛrɛχlɛrdɛ
دەرەخلەرنى	dɛrɛχlɛrni
دەستىگاھتا	dɛstiɡahta
دەستىگاھقا	dɛstiɡahqa
دەستىگاھنى	dɛstiɡahni
دەقىقىدىلا	dɛqiqidila
رازىمەنلىك	razimɛnlik
رايونلاردا	rajonlarda
رايونلارغا	rajonlarʁa
رايونىدىكى	rajonidiki
رېئاللىقنى	realliqni
رېلىسلارنى	relislarni
رەختلەرنىڭ	rɛχtlɛrniŋ
رەسىملەرمۇ	rɛsimlɛrmu
رەندىلەشكە	rɛndilɛʃkɛ
رەھمىتىنىڭ	rɛhmitiniŋ
زىرائەتلەر	ziraɛtlɛr
زەنجىرىدىن	zɛnd͡ʒiridin
ساراڭلارچە	saraŋlart͡ʃɛ
سايراشلىرى	sajraʃliri
سايرىشاتتى	sajriʃatti
ساڭگىلىتىپ	saŋɡilitip
ساۋاقدىشىم	sawaqdiʃim
ستېرېئولۇق	stereoluq
سودىگەردەك	sodiɡɛrdɛk
سودىگەرنىڭ	sodiɡɛrniŋ
سوۋغىلارنى	sowʁilarni
سىرلىرىڭنى	sirliriŋni
سىقىشقىندا	siqiʃqinda
سىلاشتۇرۇپ	silaʃturup
سىلىشتۇردى	siliʃturdi
سىنىپنىڭكى	sinipniŋki
سىياھدانغا	sijahdanʁa
سىياھداننى	sijahdanni
سۆزلىشىشكە	søzliʃiʃkɛ
سۆزلىگىنىڭ	søzliɡiniŋ
سۆزلىگەندە	søzliɡɛndɛ
سۆزۈڭدىنلا	søzyŋdinla
سۈرئىتىمىز	syritimiz
سۈرەتلەرنى	syrɛtlɛrni
سېتىقچىلار	setiqt͡ʃilar
سېستىرالار	sestiralar
سېلىشتۇرۇپ	seliʃturup
سېلىۋاتقان	seliwatqan
سېلىۋالغان	seliwalʁan
سەزگۈڭدىكى	sɛzɡyŋdiki
سەكرەشكىلى	sɛkrɛʃkili
سەيناسىنىڭ	sɛjnasiniŋ
سەييارىلەر	sɛjjarilɛr
سەۋرچانلىق	sɛwrt͡ʃanliq
سەۋىيەسىگە	sɛwijɛsiɡɛ
شاگىرتلىرى	ʃaɡirtliri
شىجائەتلىك	ʃid͡ʒaɛtlik
شىركىتىمدە	ʃirkitimdɛ
شىرىقلىغان	ʃiriqliʁan
شۇغۇللىنىش	ʃuʁulliniʃ
شۇنداقتىمۇ	ʃundaqtimu
شېئىرلارنى	ʃeirlarni
شەھىرىدىكى	ʃɛhiridiki
غاجايدىغان	ʁad͡ʒajdiʁan
غوجىدارنىڭ	ʁod͡ʒidarniŋ
غودۇڭشىغان	ʁoduŋʃiʁan
غەزەپلىنىپ	ʁɛzɛplinip
فرانسىيىدە	fransijidɛ
قاتناشمىسا	qatnaʃmisa
قاتنىشىشنى	qatniʃiʃni
قاراشتىنمۇ	qaraʃtinmu
قارايدىغان	qarajdiʁan
قارايمەنكى	qarajmɛnki
قاراڭغۇلۇق	qaraŋʁuluq
قارلىغاچنى	qarliʁat͡ʃni
قارىغاندىن	qariʁandin
قارىغىنىچە	qariʁinit͡ʃɛ
قارىيلىقتا	qarijliqta
قازىنىشنىڭ	qaziniʃniŋ
قاقاسلىقنى	qaqasliqni
قالايدىغان	qalajdiʁan
قالايمىقان	qalajmiqan
قالدۇرۇشقا	qalduruʃqa
قالغانمىدۇ	qalʁanmidu
قالغانىدىم	qalʁanidim
قالغانىكەن	qalʁanikɛn
قالغىنىممۇ	qalʁinimmu
قاملاشمىدى	qamlaʃmidi
قانچىلىغان	qant͡ʃiliʁan
قايتقاندەك	qajtqandɛk
قايتىدىغان	qajtidiʁan
قايتىشاتتى	qajtiʃatti
قايرىشىشتا	qajriʃiʃta
قايرىۋەتتى	qajriwɛtti
قايناقسۇغا	qajnaqsuʁa
قاپقاراڭغۇ	qapqaraŋʁu
قاچىلانغان	qat͡ʃilanʁan
قاچىلىرىنى	qat͡ʃilirini
قوتانلاردا	qotanlarda
قوتانلارنى	qotanlarni
قورشىۋالدى	qorʃiwaldi
قورقۇنچلۇق	qorqunt͡ʃluq
قوزغالغىچە	qozʁalʁit͡ʃɛ
قوشۇنىغىمۇ	qoʃuniʁimu
قوغلىشاتتى	qoʁliʃatti
قولتۇقىدىن	qoltuqidin
قولۇڭلارنى	qoluŋlarni
قونچاقلىرى	qont͡ʃaqliri
قويغانىكەن	qojʁanikɛn
قويۇشلىرىڭ	qojuʃliriŋ
قوپۇرۇلغان	qopurulʁan
قوڭغۇراقنى	qoŋʁuraqni
قىزدۇرۇىشى	qizduruiʃi
قىزىقاتتىڭ	qiziqattiŋ
قىزىقارلىق	qiziqarliq
قىزىقمىكەن	qiziqmikɛn
قىزىمىزنىڭ	qizimizniŋ
قىزىڭلارنى	qiziŋlarni
قىسقىراشقا	qisqiraʃqa
قىلالمايدۇ	qilalmajdu
قىلالماپتۇ	qilalmaptu
قىلدىغاندۇ	qildiʁandu
قىلدۇرۇشقا	qilduruʃqa
قىلغانلىقى	qilʁanliqi
قىلغانلىكى	qilʁanliki
قىلغىنىدەك	qilʁinidɛk
قىلغۇچىدۇر	qilʁut͡ʃidur
قىلىدىغىنى	qilidiʁini
قىلىقلارنى	qiliqlarni
قىلىپتىمەن	qiliptimɛn
قىلىۋاتسام	qiliwatsam
قىلىۋاتقان	qiliwatqan
قىمىلدىشىپ	qimildiʃip
قىيىنچىلىق	qijint͡ʃiliq
قۇرۇتلارنى	qurutlarni
قۇرۇلۇشنىڭ	quruluʃniŋ
قۇرۇلۇشىنى	quruluʃini
قۇشقىچىنىڭ	quʃqit͡ʃiniŋ
قېتىرقىنىپ	qetirqinip
قېتىلىشىغا	qetiliʃiʁa
قېتىۋالىدۇ	qetiwalidu
قېرىنداشنى	qerindaʃni
قېينانامنى	qejnanamni
قەدىرلەيدۇ	qɛdirlɛjdu
قەلبىمىزنى	qɛlbimizni
قەلبىمىزگە	qɛlbimizɡɛ
قەلبىڭدىكى	qɛlbiŋdiki
قەلەمتىراچ	qɛlɛmtirat͡ʃ
قەلەندەرمۇ	qɛlɛndɛrmu
كارىزلارنى	karizlarni
كاساپەتلەر	kasapɛtlɛr
كايىشلىرىڭ	kajiʃliriŋ
كاپالەتلىك	kapalɛtlik
كاۋاساكىمۇ	kawasakimu
كاۋىلارنىڭ	kawilarniŋ
كاۋىلىرىنى	kawilirini
كىتابلارنى	kitablarni
كىرمەكتىدى	kirmɛktidi
كىرىشتۈردى	kiriʃtyrdi
كىرپىكلىرى	kirpikliri
كىرگۈزۈشكە	kirɡyzyʃkɛ
كىشىلەرنىڭ	kiʃilɛrniŋ
كىنگورۇنىڭ	kinɡoruniŋ
كىيدۈرۈپتۇ	kijdyryptu
كىيمەپتۇغۇ	kijmɛptuʁu
كىيىملىكنى	kijimlikni
كىيىملەرمۇ	kijimlɛrmu
كىيىملەرنى	kijimlɛrni
كىيىنسەممۇ	kijinsɛmmu
كىيىۋالغان	kijiwalʁan
كىيگەنىكەن	kijɡɛnikɛn
كۆتۇرۈلگەن	køturylɡɛn
كۆتۈرمەكتە	køtyrmɛktɛ
كۆتۈرۈلۈشى	køtyrylyʃi
كۆتۈرۈڭلار	køtyryŋlar
كۆتۈرەلمەس	køtyrɛlmɛs
كۆتۈرەلمەي	køtyrɛlmɛj
كۆردىڭىزمۇ	kørdiŋizmu
كۆرسىتىمەن	kørsitimɛn
كۆرسىتىپتۇ	kørsitiptu
كۆرگەزمىسى	kørɡɛzmisi
كۆرگەنىدىم	kørɡɛnidim
كۆرگەنىدۇق	kørɡɛniduq
كۆرۈنمەكتە	kørynmɛktɛ
كۆرۈنمەيدۇ	kørynmɛjdu
كۆرۈنمەپتۇ	kørynmɛptu
كۆرۈنەرلىك	kørynɛrlik
كۆرۈۋاتقان	kørywatqan
كۆرەلمەپتۇ	kørɛlmɛptu
كۆزلىرىدىن	køzliridin
كۆزلىرىڭگە	køzliriŋɡɛ
كۆزەينەككە	køzɛjnɛkkɛ
كۆممىقوناق	kømmiqonaq
كۆپلۈكىدىن	køplykidin
كۆپچىلىككە	køpt͡ʃilikkɛ
كۆپۈكچىلەر	køpykt͡ʃilɛr
كۆپەيمەكتە	køpɛjmɛktɛ
كۆچەتلەرنى	køt͡ʃɛtlɛrni
كۆڭلىكىمنى	køŋlikimni
كۆڭلىڭىزگە	køŋliŋizɡɛ
كۆۋرۈكىدىن	køwrykidin
كۈلپەتلىرى	kylpɛtliri
كۈلۈشلىرىڭ	kylyʃliriŋ
كۈلۈمسىرەپ	kylymsirɛp
كۈنتۇغدىغا	kyntuʁdiʁa
كۈنتۇغدىنڭ	kyntuʁdinŋ
كۈنلىرىنىڭ	kynliriniŋ
كۈنۈڭلارنى	kynyŋlarni
كېتىپتىمەن	ketiptimɛn
كېتىۋاتقان	ketiwatqan
كېتىۋاتىدۇ	ketiwatidu
كېتىۋەردىم	ketiwɛrdim
كېسىۋاتقان	kesiwatqan
كېسەللەرنى	kesɛllɛrni
كېلىۋاتقان	keliwatqan
كېلىۋاتىدۇ	keliwatidu
كېلىۋىدىكى	keliwidiki
كېلەرسەنمۇ	kelɛrsɛnmu
كېلەلەيمەن	kelɛlɛjmɛn
كېچىكتىڭىز	ket͡ʃiktiŋiz
كەتكەنمىدۇ	kɛtkɛnmidu
كەتكەنىدىڭ	kɛtkɛnidiŋ
كەتمىگەندۇ	kɛtmiɡɛndu
كەشتىلەپتۇ	kɛʃtilɛptu
كەشپىياتنى	kɛʃpijatni
كەشپىياتىڭ	kɛʃpijatiŋ
كەشپىياتچى	kɛʃpijatt͡ʃi
كەلتۈرمىدى	kɛltyrmidi
كەلمىگەنتى	kɛlmiɡɛnti
كەلگىنىمدە	kɛlɡinimdɛ
كەلگەنلىكى	kɛlɡɛnliki
كەلگەنىكەن	kɛlɡɛnikɛn
كەمكۈتىسىز	kɛmkytisiz
كەيپىياتىم	kɛjpijatim
كەچكىنىمىز	kɛt͡ʃkinimiz
كەچۈرۈڭلار	kɛt͡ʃyryŋlar
لىڭشىتىپتۇ	liŋʃitiptu
لۈڭگۈسىدىن	lyŋɡysidin
ماتورىنىمۇ	matorinimu
ماتېماتىكا	matematika
ماختىشىدىن	maχtiʃidin
ماددىلارنى	maddilarni
ماشىنىسىدا	maʃinisida
ماغدۇرىدىن	maʁduridin
ماقاللارنى	maqallarni
ماكسىموۋىچ	maksimowit͡ʃ
مانچېستىېر	mant͡ʃestier
ماياقلارنى	majaqlarni
مورىلاردىن	morilardin
مىدىرلاپمۇ	midirlapmu
مىسرالارنى	misralarni
مىللىتىمىز	millitimiz
مىنىۋالغان	miniwalʁan
مىڭبېگىنىڭ	miŋbeɡiniŋ
مىڭىۋاتقان	miŋiwatqan
مۆكۈنۋېلىپ	møkynwelip
مۇئەللىمگە	muɛllimɡɛ
مۇتەپەككۇر	mutɛpɛkkur
مۇراسىمىغا	murasimiʁa
مۇراسىمىمۇ	murasimimu
مۇزىكاتنىڭ	muzikatniŋ
مۇسابىقىسى	musabiqisi
مۇكاپاتىغا	mukapatiʁa
مۇكاپاتىنى	mukapatini
مۇلايىملىق	mulajimliq
مۇلاھىزىدە	mulahizidɛ
مۇناسىۋىتى	munasiwiti
مۇھەببەتنى	muhɛbbɛtni
مېھماندوست	mehmandost
مېۋىلىرىنى	mewilirini
مېۋىلەردىن	mewilɛrdin
مەدھىيىلەش	mɛdhijilɛʃ
مەدەنىيىتى	mɛdɛnijiti
مەركىزىنىڭ	mɛrkiziniŋ
مەزمۇنىدىن	mɛzmunidin
مەزمۇنىنىڭ	mɛzmuniniŋ
مەسئۇلىيەت	mɛsulijɛt
مەستانىلىق	mɛstaniliq
مەسخىرىلىك	mɛsχirilik
مەسلىھەتنى	mɛslihɛtni
مەسىلىسىنى	mɛsilisini
مەشرەپتىكى	mɛʃrɛptiki
مەقسىتىمگە	mɛqsitimɡɛ
مەكتەپتىكى	mɛktɛptiki
مەمنۇنىيەت	mɛmnunijɛt
مەنزىرىلەر	mɛnzirilɛr
مەيدىمىزنى	mɛjdimizni
مەھەللىدىن	mɛhɛllidin
مەھەللىمىز	mɛhɛllimiz
مەھەللىنىڭ	mɛhɛlliniŋ
مەھەللەمگە	mɛhɛllɛmɡɛ
نامايىشنىڭ	namajiʃniŋ
نامايىشىغا	namajiʃiʁa
نام–شۆھرەت	nam–ʃøhrɛt
نوتىسىمىدۇ	notisimidu
نۇسخىللىرى	nusχilliri
نېمىشقىدۇر	nemiʃqidur
نەتىجىسىدە	nɛtid͡ʒisidɛ
نەتىجىسىنى	nɛtid͡ʒisini
نەرسىلەرنى	nɛrsilɛrni
نەزىرىڭدىن	nɛziriŋdin
نەلەرگىدۇر	nɛlɛrɡidur
نەپرىتىنىڭ	nɛpritiniŋ
ياخشىمۇسەن	jaχʃimusɛn
يارلىنىپتۇ	jarliniptu
ياسالماقتا	jasalmaqta
ياسىلىشىغا	jasiliʃiʁa
ياسىۋالغان	jasiwalʁan
ياشايدىغان	jaʃajdiʁan
ياشايدىكەن	jaʃajdikɛn
ياشلاردىكى	jaʃlardiki
ياش–قورامى	jaʃ–qorami
ياغاچچىلىق	jaʁat͡ʃt͡ʃiliq
ياغماقتىدى	jaʁmaqtidi
يالتىراشقا	jaltiraʃqa
يالماۋۇزغا	jalmawuzʁa
يامانلىقتا	jamanliqta
يامغۇرىنىڭ	jamʁuriniŋ
يانغىنىمدا	janʁinimda
يورغىلىتىپ	jorʁilitip
يوشۇرۇنغان	joʃurunʁan
يوللانمىسى	jollanmisi
يوللىغاندا	jolliʁanda
يىتەكچىلىك	jitɛkt͡ʃilik
يىراقلارغا	jiraqlarʁa
يىراقلىشىپ	jiraqliʃip
يىراقلىقتا	jiraqliqta
يىراقلىققا	jiraqliqqa
يىغلىغىڭىز	jiʁliʁiŋiz
يىغلىۋېلىڭ	jiʁliweliŋ
يىغلىۋەتتى	jiʁliwɛtti
يىغىشتۇردى	jiʁiʃturdi
يىللاردىكى	jillardiki
يىگتۋېشىغا	jiɡtweʃiʁa
يۆتكەيتتۇق	jøtkɛjttuq
يۇرتداشلار	jurtdaʃlar
يۇرتىمىزغا	jurtimizʁa
يۇرتىمىزنى	jurtimizni
يۈز–كۆزىنى	jyz–køzini
يۈز–كۆزىگە	jyz–køziɡɛ
يۈگۈرەلمەي	jyɡyrɛlmɛj
يۈگۈرەيتتى	jyɡyrɛjtti
يېتىشەلمەي	jetiʃɛlmɛj
يېتىلدۈرۈش	jetildyryʃ
يېرىلغۇدەك	jerilʁudɛk
يېزىمىزنىڭ	jezimizniŋ
يېشىللىققا	jeʃilliqqa
يېغىۋاتقان	jeʁiwatqan
يېقىنلاشتى	jeqinlaʃti
يېقىنلىشىپ	jeqinliʃip
يېقىنلىشىڭ	jeqinliʃiŋ
يېمەكلىكنى	jemɛklikni
يېپىلغاندا	jepilʁanda
يەرلىرىدىن	jɛrliridin
يەشىكلەرگە	jɛʃiklɛrɡɛ
يەكتەكلىرى	jɛktɛkliri
يەڭگۈشلىدى	jɛŋɡyʃlidi
پائالىيىتى	paalijiti
پاتنېنتىنى	patnentini
پادىشاھنىڭ	padiʃahniŋ
پاراسەتلىك	parasɛtlik
پاراڭلىشىپ	paraŋliʃip
پارتىدىشىم	partidiʃim
پارتىلارنى	partilarni
پاكىزلىققا	pakizliqqa
پاكىزلىقنى	pakizliqni
پالاقشىغان	palaqʃiʁan
پالتىلارمۇ	paltilarmu
پايدىلىنىپ	pajdilinip
پىداكارلار	pidakarlar
پىرسەنتىنى	pirsɛntini
پىشانىسىگە	piʃanisiɡɛ
پىشۇرۇلغان	piʃurulʁan
پۇتلىرىدىن	putliridin
پۇقراسىنىڭ	puqrasiniŋ
پۈتتۈرىمەن	pyttyrimɛn
پۈتكۈزۈپتۇ	pytkyzyptu
پۈۋلەۋېرىپ	pywlɛwerip
پەخىرلىنىش	pɛχirliniʃ
پەزىلەتتۇر	pɛzilɛttur
پەزىلەتلىك	pɛzilɛtlik
چارۋىچىلىق	t͡ʃarwit͡ʃiliq
چاغدىكىدەك	t͡ʃaʁdikidɛk
چاغلاردىكى	t͡ʃaʁlardiki
چاغلاردىلا	t͡ʃaʁlardila
چاغلىرىمىز	t͡ʃaʁlirimiz
چاققانغىنا	t͡ʃaqqanʁina
چاقىرتىپتۇ	t͡ʃaqirtiptu
چاقىرىمدىن	t͡ʃaqirimdin
چامىسىدىكى	t͡ʃamisidiki
چوققىسىدىن	t͡ʃoqqisidin
چوققىلارنى	t͡ʃoqqilarni
چوڭايغاندا	t͡ʃoŋajʁanda
چوڭىيىشىغا	t͡ʃoŋijiʃiʁa
چىدىيالماي	t͡ʃidijalmaj
چىرايىمدىن	t͡ʃirajimdin
چىرقىرىشىپ	t͡ʃirqiriʃip
چىشلىۋېلىپ	t͡ʃiʃliwelip
چىقارماقچى	t͡ʃiqarmaqt͡ʃi
چىقىرىشىنى	t͡ʃiqiriʃini
چىقىرىلغان	t͡ʃiqirilʁan
چىقىرىلىدۇ	t͡ʃiqirilidu
چىقىۋاتقان	t͡ʃiqiwatqan
چىمەنلىكنى	t͡ʃimɛnlikni
چىيۇۋچىمىڭ	t͡ʃijuwt͡ʃimiŋ
چۆرىسىدىكى	t͡ʃørisidiki
چۆرگىلىتىپ	t͡ʃørɡilitip
چۇرقىرىشىپ	t͡ʃurqiriʃip
چۇۋۇرلىشىپ	t͡ʃuwurliʃip
چۈشىنىكسىز	t͡ʃyʃiniksiz
چۈشىنەتتىڭ	t͡ʃyʃinɛttiŋ
چۈشەندۈرۈش	t͡ʃyʃɛndyryʃ
چۈشەندۈرۈپ	t͡ʃyʃɛndyryp
چېركاۋدىكى	t͡ʃerkawdiki
چېلىۋاتىدۇ	t͡ʃeliwatidu
چېچىلغاندا	t͡ʃet͡ʃilʁanda
چېچىۋاتقان	t͡ʃet͡ʃiwatqan
چەتئەلدىكى	t͡ʃɛtɛldiki
چەكچىيىپتۇ	t͡ʃɛkt͡ʃijiptu
گالىلېينىڭ	ɡalilejniŋ
گاڭگىرىتىپ	ɡaŋɡiritip
گىئولوگنىڭ	ɡioloɡniŋ
گۈزەللىشىپ	ɡyzɛlliʃip
گۈزەللىكنى	ɡyzɛllikni
گۈزەلمىكەن	ɡyzɛlmikɛn
گۈللىرىنىڭ	ɡylliriniŋ
گېئولوگنىڭ	ɡeoloɡniŋ
گېئولوگىيە	ɡeoloɡijɛ
گېپىمىزدىن	ɡepimizdin
گەۋدىلىنىپ	ɡɛwdilinip
ھارارەتتەك	hararɛttɛk
ھاردۇقۇمنى	harduqumni
ھارغىنلىقى	harʁinliqi
ھارۋىسىنىڭ	harwisiniŋ
ھارۋىكەشمۇ	harwikɛʃmu
ھازىرقىدەك	hazirqidɛk
ھازىرلىغان	hazirliʁan
ھاشاراتلار	haʃaratlar
ھالقىسىمان	halqisiman
ھاياجانلىق	hajad͡ʒanliq
ھاڭ–تاڭلىق	haŋ–taŋliq
ھوزۇرلىنىش	hozurliniʃ
ھويلىسىدىن	hojlisidin
ھويلىلاردا	hojlilarda
ھۇزۇرلىنىپ	huzurlinip
ھېسابلايدۇ	hesablajdu
ھېكايىسىنى	hekajisini
ھېكىمەتلەر	hekimɛtlɛr
ھېچنەرسىنى	het͡ʃnɛrsini
ھەربىرىنىڭ	hɛrbiriniŋ
ھەرىكەتچان	hɛrikɛtt͡ʃan
ھەرىلىرىنى	hɛrilirini
ھەشەمەتلىك	hɛʃɛmɛtlik
ھەقىقەتنىڭ	hɛqiqɛtniŋ
ھەمراھلىرى	hɛmrahliri
ھەممىمىزگە	hɛmmimizɡɛ
ھەپىلەشكەن	hɛpilɛʃkɛn
ھەۋەسلىنىپ	hɛwɛslinip
ۋارانلارنى	waranlarni
ۋارقىراپتۇ	warqiraptu
ۋارقىرىدۇق	warqiriduq
ۋارقىرىشىپ	warqiriʃip
ۋارقىرىغان	warqiriʁan
ۋاقتىمدىمۇ	waqtimdimu
ۋاقتىمىزدا	waqtimizda
ۋاقىتلاردا	waqitlarda
ۋاقىتلىرىم	waqitlirim
ۋاقىتلىرىڭ	waqitliriŋ
ۋوگزالدىكى	woɡzaldiki
ۋىجدانىڭىز	wid͡ʒdaniŋiz
ۋۇجۇدىدىكى	wud͡ʒudidiki
ۋەزىرىمىنى	wɛzirimini
ۋەزىپىسىنى	wɛzipisini
ۋەزىپىلىرى	wɛzipiliri
‹‹قاچا››دا	‹‹qat͡ʃa››da
ئاتىۋېتەتتى	atiwetɛtti
ئاجايىپلىقى	ad͡ʒajipliqi
ئاخىرلاشقان	aχirlaʃqan
ئادەتتىكىچە	adɛttikit͡ʃɛ
ئادەملىكىنى	adɛmlikini
ئادەملەررنى	adɛmlɛrrni
ئادەملەرنىڭ	adɛmlɛrniŋ
ئاراڭلاردىن	araŋlardin
ئارتىلغانمۇ	artilʁanmu
ئارقىسىدىكى	arqisidiki
ئاستا–ئاستا	asta–asta
ئاشخانىدىكى	aʃχanidiki
ئاغزىلىرىنى	aʁzilirini
ئاقارتىلغان	aqartilʁan
ئاقىۋىتىنىڭ	aqiwitiniŋ
ئالتۇنلارنى	altunlarni
ئالدامچىلار	aldamt͡ʃilar
ئالدامچىنىڭ	aldamt͡ʃiniŋ
ئالداۋاتىدۇ	aldawatidu
ئالدىمىزدىن	aldimizdin
ئالمىشىشنىڭ	almiʃiʃniŋ
ئالىمجاننىڭ	alimd͡ʒanniŋ
ئالىيلىرىنى	alijlirini
ئاماننىسانى	amannisani
ئامېرىكىلىق	amerikiliq
ئامېرىكىنىڭ	amerikiniŋ
ئانىلىرىدىن	aniliridin
ئانىڭىزغىمۇ	aniŋizʁimu
ئانچە–مۇنچە	ant͡ʃɛ–munt͡ʃɛ
ئاياغلىشىشى	ajaʁliʃiʃi
ئايتۇغدىنىڭ	ajtuʁdiniŋ
ئايلانغاندا	ajlanʁanda
ئاپتوبۇستىن	aptobustin
ئاپتوبۇسنىڭ	aptobusniŋ
ئاپىرالايدۇ	apiralajdu
ئاچچىقلىنىپ	at͡ʃt͡ʃiqlinip
ئاڭلانماقتا	aŋlanmaqta
ئاڭلايدىغان	aŋlajdiʁan
ئاڭلىغاندىن	aŋliʁandin
ئاڭلىيالماي	aŋlijalmaj
ئاۋارىچىلىك	awarit͡ʃilik
ئاۋۇندۇردۇم	awundurdum
ئوتتۇرىسىغا	otturisiʁa
ئوخشايدىغان	oχʃajdiʁan
ئوخشايدىكەن	oχʃajdikɛn
ئوخشىمامسەن	oχʃimamsɛn
ئوخشىمايتتى	oχʃimajtti
ئورمانلارنى	ormanlarni
ئورمانلىققا	ormanliqqa
ئورنىتىلغان	ornitilʁan
ئورنىمىزدىن	ornimizdin
ئورنىڭىزدىن	orniŋizdin
ئورىۋېلىشتى	oriweliʃti
ئورۇندۇقتىن	orunduqtin
ئورۇندۇقلار	orunduqlar
ئوساللىقىنى	osalliqini
ئوغۇللارنىڭ	oʁullarniŋ
ئوقۇتقۇچىغا	oqutqut͡ʃiʁa
ئوقۇتقۇچىنى	oqutqut͡ʃini
ئوقۇشلۇقلار	oquʃluqlar
ئوقۇغۇچىلار	oquʁut͡ʃilar
ئوقۇغۇچىلىق	oquʁut͡ʃiliq
ئوقۇغۇچىنىڭ	oquʁut͡ʃiniŋ
ئوقۇۋاتاتتى	oquwatatti
ئولتۇراتتىم	olturattim
ئولتۇراتتۇق	olturattuq
ئولتۇرغۇدەك	olturʁudɛk
ئولتۇرۋېلىپ	olturwelip
ئويلاپتىمەن	ojlaptimɛn
ئويلىغىنىدا	ojliʁinida
ئويمانلىقنى	ojmanliqni
ئويناقشىتىپ	ojnaqʃitip
ئويناقلىشىپ	ojnaqliʃip
ئويناۋاتقان	ojnawatqan
ئوچۇمىڭىزغا	ot͡ʃumiŋizʁa
ئوڭشىيالماس	oŋʃijalmas
ئىتتىرىشكەن	ittiriʃkɛn
ئىختىيارسىز	iχtijarsiz
ئىزدىنىشتىن	izdiniʃtin
ئىزدىنىشىگە	izdiniʃiɡɛ
ئىزدەنمەكتە	izdɛnmɛktɛ
ئىزدە–ئىزدە	izdɛ–izdɛ
ئىزنالىرىنى	iznalirini
ئىسراپچىلىق	israpt͡ʃiliq
ئىسسىتماقچى	issitmaqt͡ʃi
ئىسسىقلىقنى	issiqliqni
ئىشخانىسىغا	iʃχanisiʁa
ئىشلىتىشتىن	iʃlitiʃtin
ئىشلىتىلىدۇ	iʃlitilidu
ئىشلىگىنىگە	iʃliɡiniɡɛ
ئىشلىگۈچىگە	iʃliɡyt͡ʃiɡɛ
ئىشلەتكىنىڭ	iʃlɛtkiniŋ
ئىشلەيسىلەر	iʃlɛjsilɛr
ئىشلەۋاتقان	iʃlɛwatqan
ئىشىكلەرنىڭ	iʃiklɛrniŋ
ئىشىنىدىكەن	iʃinidikɛn
ئىشىنىشىمىز	iʃiniʃimiz
ئىشىنىمەنكى	iʃinimɛnki
ئىقتىدارىغا	iqtidariʁa
ئىقتىسادتىن	iqtisadtin
ئىككىمىزنىڭ	ikkimizniŋ
ئىكەنلىكىنى	ikɛnlikini
ئىللىقلىققا	illiqliqqa
ئىللىقلىقنى	illiqliqni
ئىلىم–پەنمۇ	ilim–pɛnmu
ئىلىم–پەنگە	ilim–pɛnɡɛ
ئىنسانلارغا	insanlarʁa
ئىنسانلارمۇ	insanlarmu
ئىنسانلارنى	insanlarni
ئىنشالىرىنى	inʃalirini
ئىنقلابىنىڭ	inqlabiniŋ
ئىنقىلابىغا	inqilabiʁa
ئىنژېنېرلار	inʒenerlar
ئىچ–ئىچىدىن	it͡ʃ–it͡ʃidin
ئىگىلىنىشچە	iɡiliniʃt͡ʃɛ
ئۆتكۈزۈلگەن	øtkyzylɡɛn
ئۆزگىرىشلەر	øzɡiriʃlɛr
ئۆزگىرىشچان	øzɡiriʃt͡ʃan
ئۆزۈڭلارنىڭ	øzyŋlarniŋ
ئۆسۈملۈكلەر	øsymlyklɛr
ئۆيىمىزدىكى	øjimizdiki
ئۆچۈرۈلگۈچە	øt͡ʃyrylɡyt͡ʃɛ
ئۆگىنىدىغان	øɡinidiʁan
ئۇخلايدىكەن	uχlajdikɛn
ئۇرۇقداشلىق	uruqdaʃliq
ئۇرۇقلىرىنى	uruqlirini
ئۇرۇلۇشىدىن	uruluʃidin
ئۇسۇللىرىنى	usullirini
ئۇقمايدىغان	uqmajdiʁan
ئۇلۇغلۇقىنى	uluʁluqini
ئۇنتۇلغۇسىز	untulʁusiz
ئۇنىمىساقمۇ	unimisaqmu
ئۇچقۇچىلىرى	ut͡ʃqut͡ʃiliri
ئۇچىرغاندەك	ut͡ʃirʁandɛk
ئۈلگۈرمىگەن	ylɡyrmiɡɛn
ئۈنمەيدىكەن	ynmɛjdikɛn
ئېرىشكەندەك	eriʃkɛndɛk
ئېسىلىۋېلىپ	esiliwelip
ئېغىرلىقىنى	eʁirliqini
ئېقىتقىنىچە	eqitqinit͡ʃɛ
ئېقىۋىتىپتۇ	eqiwitiptu
ئېلىشقىنىچە	eliʃqinit͡ʃɛ
ئېيتىۋاتىدۇ	ejtiwatidu
ئېچىلغاندەك	et͡ʃilʁandɛk
ئېچىلىدىكەن	et͡ʃilidikɛn
ئېگزلىكتىكى	eɡzliktiki
ئېگىزلىكتىن	eɡizliktin
ئېھتىياجلىق	ehtijad͡ʒliq
ئەتراپىدىكى	ɛtrapidiki
ئەتىگەنلىكى	ɛtiɡɛnliki
ئەجەبلىنىدۇ	ɛd͡ʒɛblinidu
ئەركىنلىككە	ɛrkinlikkɛ
ئەزالىرىنىڭ	ɛzaliriniŋ
ئەسكەرلىككە	ɛskɛrlikkɛ
ئەسەرلىرىنى	ɛsɛrlirini
ئەقىدىمىزگە	ɛqidimizɡɛ
ئەمىلىيەتتە	ɛmilijɛttɛ
ئەمگىكىڭنىڭ	ɛmɡikiŋniŋ
ئەمەستۇرمەن	ɛmɛsturmɛn
ئەمەللەردىن	ɛmɛllɛrdin
ئەمەلىيەتتە	ɛmɛlijɛttɛ
ئەنسىزلىككە	ɛnsizlikkɛ
ئەنگىلىينىڭ	ɛnɡilijniŋ
ئەنگىلىيىدە	ɛnɡilijidɛ
ئەھمىيەتسىز	ɛhmijɛtsiz
ئەھمىيەتلىك	ɛhmijɛtlik
باتارېيىنىڭ	batarejiniŋ
باتۇرلاردەك	baturlardɛk
باتۇرلىقىغا	baturliqiʁa
باشاقلىرىنى	baʃaqlirini
باشقىلارنىڭ	baʃqilarniŋ
باشقۇرۇلۇشى	baʃquruluʃi
باغلانغاندا	baʁlanʁanda
باغلايدىكەن	baʁlajdikɛn
باقمايمىزمۇ	baqmajmizmu
بالىلىرىدىن	baliliridin
بالىلىرىدەك	baliliridɛk
بالىلىرىمىز	balilirimiz
بالىلىرىنىڭ	baliliriniŋ
بالىمىزنىمۇ	balimiznimu
بوتۇلكىسىنى	botulkisini
بوستانلىقتا	bostanliqta
بوشلۇقىدىكى	boʃluqidiki
بولدىكەنسەن	boldikɛnsɛn
بولغاندىكىن	bolʁandikin
بولماقتىمىز	bolmaqtimiz
بولمامدىكىن	bolmamdikin
بولمايدىكەن	bolmajdikɛn
بولمىغاندەك	bolmiʁandɛk
بولىدىكەنغۇ	bolidikɛnʁu
بولۇۋاتىمىز	boluwatimiz
بويلىرىدىكى	bojliridiki
بىرەلمەيمەن	birɛlmɛjmɛn
بىلدۈرۈشىدۇ	bildyryʃidu
بىلمەيسىلەر	bilmɛjsilɛr
بىلىنىدىكەن	bilinidikɛn
بىلەكلىرىگە	bilɛkliriɡɛ
بىچارىلەرەي	bit͡ʃarilɛrɛj
بۆلمەيدىكەن	bølmɛjdikɛn
بۇلدۇقلايدۇ	bulduqlajdu
بۇلۇڭىدىنمۇ	buluŋidinmu
بۇيۇملىرىنى	bujumlirini
بۈگۈنىمىزگە	byɡynimizɡɛ
بېرىشىڭىزنى	beriʃiŋizni
بېرىۋاتسىمۇ	beriwatsimu
بېرىۋېتىسەن	beriwetisɛn
بېرەلمەيتتى	berɛlmɛjtti
بېرەلمەيسەن	berɛlmɛjsɛn
بېشارىتىدەك	beʃaritidɛk
بېغشلىشىمىز	beʁʃliʃimiz
بېقىۋالغىلى	beqiwalʁili
بەرمىگەندەك	bɛrmiɡɛndɛk
بەرگەنلىكنى	bɛrɡɛnlikni
بەزىلىرىنىڭ	bɛziliriniŋ
بەلگىلەنگەن	bɛlɡilɛnɡɛn
تارتقانلىقى	tartqanliqi
تارتمايتتۇق	tartmajttuq
تارقىلالماي	tarqilalmaj
تارماقلارغا	tarmaqlarʁa
تاشئالمىلار	taʃalmilar
تاشقىنلىققا	taʃqinliqqa
تاشلىۋەتكەن	taʃliwɛtkɛn
تاغارلاردىن	taʁarlardin
تاغار–تاغار	taʁar–taʁar
تاغدىنچۈشۈپ	taʁdint͡ʃyʃyp
تاقاشقاندەك	taqaʃqandɛk
تاقەتسىزلىك	taqɛtsizlik
تالونلىرىنى	talonlirini
تاماملىنىدۇ	tamamlinidu
تامچىلىرىغا	tamt͡ʃiliriʁa
تاپالمايتتى	tapalmajtti
تاپمايدىغان	tapmajdiʁan
تاۋارلىرىنى	tawarlirini
توختىمايتتى	toχtimajtti
تورغايلارنى	torʁajlarni
توسۇۋېلىشقا	tosuweliʃqa
توغرىسىدىكى	toʁrisidiki
توغرىلىقىغا	toʁriliqiʁa
توققۇزلاردا	toqquzlarda
توقۇمىچىلىق	toqumit͡ʃiliq
توقۇۋاتسىمۇ	toquwatsimu
تونۇشتۇرغان	tonuʃturʁan
تىرىشچانلىق	tiriʃt͡ʃanliq
تىرىكچىلىكى	tirikt͡ʃiliki
تىزلىگىدىكى	tizliɡidiki
تىزىملاتقان	tizimlatqan
تىزىملانغان	tizimlanʁan
تىقىلىدىكەن	tiqilidikɛn
تىللىۋەتتىم	tilliwɛttim
تۇرالمايمەن	turalmajmɛn
تۇرغۇزۇلغان	turʁuzulʁan
تۇرمايدىغان	turmajdiʁan
تۇرۇۋاتاتتى	turuwatatti
تۇيماپتىمەن	tujmaptimɛn
تېتىيالايدۇ	tetijalajdu
تېخنىكىسىمۇ	teχnikisimu
تېكىستلەرنى	tekistlɛrni
تېلېفونىسىت	telefonisit
تېمپىراتۇرا	tempiratura
تېمپېراتۇرا	temperatura
تېپىلىدىكەن	tepilidikɛn
تەئەججۇپلۇق	tɛɛd͡ʒd͡ʒupluq
تەبرىكلەمدۇ	tɛbriklɛmdu
تەبرىكلەيدۇ	tɛbriklɛjdu
تەتقىقاتىدا	tɛtqiqatida
تەربىيىسىگە	tɛrbijisiɡɛ
تەرىپلىنىدۇ	tɛriplinidu
تەرەققىياتى	tɛrɛqqijati
تەرەپلىرىگە	tɛrɛpliriɡɛ
تەرەپلەردىن	tɛrɛplɛrdin
تەسۋىرلىنىپ	tɛswirlinip
تەكرارلىدىم	tɛkrarlidim
تەكشۈرۈشتىن	tɛkʃyryʃtin
تەلىماتىنىڭ	tɛlimatiniŋ
تەلۋىلىكتىن	tɛlwiliktin
تەمىنلىگۈچى	tɛminliɡyt͡ʃi
تەييارلاندى	tɛjjarlandi
تەپەككۇرنىڭ	tɛpɛkkurniŋ
تەڭرىتاغنىڭ	tɛŋritaʁniŋ
تەڭرىتېغىغا	tɛŋriteʁiʁa
تەڭلەشمەيدۇ	tɛŋlɛʃmɛjdu
تەۋرىتىلگەن	tɛwritilɡɛn
جاراڭلايتتى	d͡ʒaraŋlajtti
جايلىرىدىكى	d͡ʒajliridiki
جىمجىتلىقتا	d͡ʒimd͡ʒitliqta
جۆيلىگەنلىك	d͡ʒøjliɡɛnlik
جەريانىدىكى	d͡ʒɛrjanidiki
خاتالىقىمنى	χataliqimni
خاتىرىلىرىم	χatirilirim
خادىملارنىڭ	χadimlarniŋ
خاراكتېرىنى	χarakterini
خوشاللىقتىن	χoʃalliqtin
خوشاللىقىدا	χoʃalliqida
خۇشاللىقتىن	χuʃalliqtin
خەلقئارالىق	χɛlqaraliq
داۋاملىشىدۇ	dawamliʃidu
داۋانلىرىدا	dawanlirida
دوستلىرىنىڭ	dostliriniŋ
دولقۇنلارنڭ	dolqunlarnŋ
دوپ–دوغىلاق	dop–doʁilaq
دىھقانچىلىق	dihqant͡ʃiliq
دۆلەتلەرنىڭ	dølɛtlɛrniŋ
دۇئالىرىڭدا	dualiriŋda
دۇنياسىدىكى	dunjasidiki
دېرىزىلەردە	derizilɛrdɛ
دېرىزىلەرگە	derizilɛrɡɛ
دېيىلگەندەك	dejilɡɛndɛk
دېگەنلىكىنى	deɡɛnlikini
دېھقانچىلىق	dehqant͡ʃiliq
دەرسخانىنىڭ	dɛrsχaniniŋ
دەرياسى››نى	dɛrjasi››ni
دەرۋازىسىدا	dɛrwazisida
دەرۋازىسىغا	dɛrwazisiʁa
دەرۋازىسىنى	dɛrwazisini
دەستىىگاھتا	dɛstiiɡahta
دەستىگاھتىن	dɛstiɡahtin
دەستىگاھىدا	dɛstiɡahida
دەپتىرىنىمۇ	dɛptirinimu
دەۋا–دەستۇر	dɛwa–dɛstur
دەۋرلەردىلا	dɛwrlɛrdila
رايونلارنىڭ	rajonlarniŋ
رەسمىيىتىنى	rɛsmijitini
زىيارەتچىنى	zijarɛtt͡ʃini
زەخىملەنگەن	zɛχimlɛnɡɛn
زەينىدىننىڭ	zɛjnidinniŋ
سائەتلەردىن	saɛtlɛrdin
ساتىراشخانا	satiraʃχana
ساغلاملىقنى	saʁlamliqni
ساقلايدىغان	saqlajdiʁan
سانسىزلىغان	sansizliʁan
سايمانلارغا	sajmanlarʁa
ساۋاقداشلار	sawaqdaʃlar
سوراۋاتىمەن	sorawatimɛn
سوغۇققانلىق	soʁuqqanliq
سوپىسوپىياڭ	sopisopijaŋ
سىزىلغانىدى	sizilʁanidi
سىغمايدىغان	siʁmajdiʁan
سىنەكىمىدىم	sinɛkimidim
سۆزلىگىنىچە	søzliɡinit͡ʃɛ
سۆزلەيدىغان	søzlɛjdiʁan
سۇغۇرالايدۇ	suʁuralajdu
سۈرئىىتىمنى	syriitimni
سۈرىتىڭىزنى	syritiŋizni
سۈپۈرۈۋېتىپ	sypyrywetip
سېلىشتۇرىدۇ	seliʃturidu
سېلىنۋاتقان	selinwatqan
سېلىۋېتىشكە	seliwetiʃkɛ
سەككىزلەردە	sɛkkizlɛrdɛ
سەۋرچانلىقى	sɛwrt͡ʃanliqi
شىركەتلەرمۇ	ʃirkɛtlɛrmu
شىۋېتسارىيە	ʃiwetsarijɛ
شەھرىزادنىڭ	ʃɛhrizadniŋ
غوجاكىسىدىن	ʁod͡ʒakisidin
غىزالانغىلى	ʁizalanʁili
فابرىكىلىرى	fabrikiliri
فرانسىيىلىك	fransijilik
قاتارلىقلار	qatarliqlar
قاتلىمىدىكى	qatlimidiki
قاراشلىرىنى	qaraʃlirini
قارلىغاچلار	qarliʁat͡ʃlar
قارىغانلىقى	qariʁanliqi
قارىغىنىمدا	qariʁinimda
قالغاندىمەن	qalʁandimɛn
قالغىنىمدىن	qalʁinimdin
قاناتلىرىنى	qanatlirini
قايتقىنىمدا	qajtqinimda
قايسىمىزنىڭ	qajsimizniŋ
قاچانلاردىن	qat͡ʃanlardin
قاڭالتىرىغا	qaŋaltiriʁa
قورققىنىدىن	qorqqinidin
قورۇمۇلارنى	qorumularni
قوغدايدىغان	qoʁdajdiʁan
قوغۇنلارنىڭ	qoʁunlarniŋ
قولتۇقۇمدىن	qoltuqumdin
قوماندانلىق	qomandanliq
قونچاقلارنى	qont͡ʃaqlarni
قونۇۋالاتتى	qonuwalatti
قويغانلىقىم	qojʁanliqim
قويۇلغاندەك	qojulʁandɛk
قويۇلىدىغان	qojulidiʁan
قوڭغۇراقنىڭ	qoŋʁuraqniŋ
قىرائەتخانا	qiraɛtχana
قىزدۇرغاندا	qizdurʁanda
قىزىقسىنغان	qiziqsinʁan
قىزىقىشىمنى	qiziqiʃimni
قىستۇرۇلغان	qisturulʁan
قىلالىشىمغا	qilaliʃimʁa
قىلغىنىڭلار	qilʁiniŋlar
قىلماقتىمىز	qilmaqtimiz
قىلماقچىكەن	qilmaqt͡ʃikɛn
قىلمايدىغان	qilmajdiʁan
قىلمىغانىدى	qilmiʁanidi
قىلىدىغاننى	qilidiʁanni
قىلىنمايتتى	qilinmajtti
قىلىۋاتاتتى	qiliwatatti
قىلىۋاتىسىز	qiliwatisiz
قىلىۋاتىمىز	qiliwatimiz
قىلىۋېتىپتۇ	qiliwetiptu
قۇرۇلۇشلىرى	quruluʃliri
قۇرۇلۇشىدىن	quruluʃidin
قۇسىۋەتكىلى	qusiwɛtkili
قېرىشقاندەك	qeriʃqandɛk
قېرىنداشلىق	qerindaʃliq
قېرىندىشىنى	qerindiʃini
قەتئىينەزەر	qɛtijnɛzɛr
قەلىمىڭىزنى	qɛlimiŋizni
كارامىتىڭنى	karamitiŋni
كارتىلدىتىپ	kartilditip
كاۋىلىرىدىن	kawiliridin
كاۋىلىرىنىڭ	kawiliriniŋ
كوللىكتىپقا	kolliktipqa
كوللېكتىپقا	kollektipqa
كولىغانىكەن	koliʁanikɛn
كومپيۇتېردا	kompjuterda
كومپيۇتېرغا	kompjuterʁa
كومپيۇتېرنى	kompjuterni
كىلاۋچىكلار	kilawt͡ʃiklar
كىلومېتىرغا	kilometirʁa
كىيىملىرىنى	kijimlirini
كىيىملىرىگە	kijimliriɡɛ
كىيىملەردىن	kijimlɛrdin
كۆتۈرۈلۈپتۇ	køtyrylyptu
كۆرسەتمەكچى	kørsɛtmɛkt͡ʃi
كۆرمىگىنىنى	kørmiɡinini
كۆرمەيدىكەن	kørmɛjdikɛn
كۆرۈشىدىغان	køryʃidiʁan
كۆرۈنمىدىمۇ	kørynmidimu
كۆرۈنمەيتتى	kørynmɛjtti
كۆرۈنۈشىدىن	kørynyʃidin
كۆرۈۋاتىمەن	kørywatimɛn
كۆرۈۋالىمەن	kørywalimɛn
كۆزلىرىدىمۇ	køzliridimu
كۆزىمىزگىمۇ	køzimizɡimu
كۆپىيەلەيدۇ	køpijɛlɛjdu
كۆپۈكچىلىرى	køpykt͡ʃiliri
كۆچۈرىدىكەن	køt͡ʃyridikɛn
كۈتكۈچىلىرى	kytkyt͡ʃiliri
كۈلىۋەتكىنە	kyliwɛtkinɛ
كۈلگەندەكلا	kylɡɛndɛkla
كۈلۈمسىرىدى	kylymsiridi
كۈلۈمسىرىشى	kylymsiriʃi
كۈلۈۋېتىپتۇ	kylywetiptu
كۈنتۇغدىنىڭ	kyntuʁdiniŋ
كۈندن–كۈنگە	kyndn–kynɡɛ
كۈنلىرىدىمۇ	kynliridimu
كۈچلەندۈرۈپ	kyt͡ʃlɛndyryp
كۈچۈكلىرىنى	kyt͡ʃyklirini
كېتىشكەنىدى	ketiʃkɛnidi
كېتىۋاتاتتى	ketiwatatti
كېتىۋاتىمىز	ketiwatimiz
كېتىۋاتىمەن	ketiwatimɛn
كېرەكلىكىنى	kerɛklikini
كېلىشىمىزنى	keliʃimizni
كېلىشىمگىلا	keliʃimɡila
كېلىۋاتاتتى	keliwatatti
كېلىۋاتىمەن	keliwatimɛn
كېلەلمەيمەن	kelɛlmɛjmɛn
كەتمەيدىغان	kɛtmɛjdiʁan
كەشتىلەنگەن	kɛʃtilɛnɡɛn
كەشپىياتىغا	kɛʃpijatiʁa
كەشپىياتىنى	kɛʃpijatini
كەلمەيدىغان	kɛlmɛjdiʁan
كەلمەپتىمەن	kɛlmɛptimɛn
كەلگۈسىدىكى	kɛlɡysidiki
كەمچىلىكىنى	kɛmt͡ʃilikini
كەنتىمىزنىڭ	kɛntimizniŋ
كەچۈرەلەيدۇ	kɛt͡ʃyrɛlɛjdu
لايىھەلىگەن	lajihɛliɡɛn
لىباسلىرىنى	libaslirini
لۇتپۇللانىڭ	lutpullaniŋ
لېنىنگرادتا	leninɡradta
لەززىتىنىلا	lɛzzitinila
لەززىتىنىمۇ	lɛzzitinimu
ماتېرىيالغا	materijalʁa
ماددىلارنىڭ	maddilarniŋ
مارجانبۇلاق	mard͡ʒanbulaq
مارجانلارغا	mard͡ʒanlarʁa
مارجانلارنى	mard͡ʒanlarni
ماركىلىرىنى	markilirini
ماركىلىرىنڭ	markilirinŋ
ماشىنىسىدىن	maʃinisidin
ماشىنىلارنى	maʃinilarni
مامكاپلارغا	mamkaplarʁa
ماياقلارنىڭ	majaqlarniŋ
مىلتىقىمنىڭ	miltiqimniŋ
مۆكۈۋېلىشنى	møkyweliʃni
مۇئەللىملەر	muɛllimlɛr
مۇئەللىمنىڭ	muɛllimniŋ
مۇرائۇچىدىن	muraut͡ʃidin
مۇشەققەتلىك	muʃɛqqɛtlik
مۇناسىۋەتكە	munasiwɛtkɛ
مېڭىۋېرىپتۇ	meŋiweriptu
مېھرىبانلىق	mehribanliq
مېھرىڭلارغا	mehriŋlarʁa
مېھرىڭلارنى	mehriŋlarni
مەدەنيىتىگە	mɛdɛnjitiɡɛ
مەرەشكىنىچە	mɛrɛʃkinit͡ʃɛ
مەزمۇنلارمۇ	mɛzmunlarmu
مەسئۇلىيىتى	mɛsulijiti
مەسىلىلەرنى	mɛsililɛrni
مەسىلىلەرگە	mɛsililɛrɡɛ
مەشرىپى››گە	mɛʃripi››ɡɛ
مەشرەپلەردە	mɛʃrɛplɛrdɛ
مەنزىرىسىنى	mɛnzirisini
مەنزىرىسىگە	mɛnzirisiɡɛ
مەيدانىدىكى	mɛjdanidiki
مەھەللىدىكى	mɛhɛllidiki
مەھەللىسىدە	mɛhɛllisidɛ
مەھەللىسىگە	mɛhɛllisiɡɛ
مەھەللەمنىڭ	mɛhɛllɛmniŋ
ناۋايلىقتىن	nawajliqtin
نىكودىموۋىچ	nikodimowit͡ʃ
نۇسقىلىرىنى	nusqilirini
نەرسىلەردىن	nɛrsilɛrdin
نەرسەباردەك	nɛrsɛbardɛk
ياراتقۇچىسى	jaratqut͡ʃisi
ياردەملىشىپ	jardɛmliʃip
ياردەملەشسە	jardɛmlɛʃsɛ
يارلانمىغان	jarlanmiʁan
يارىشىپتىمۇ	jariʃiptimu
يالماۋۇزنىڭ	jalmawuzniŋ
يانداشتۇردى	jandaʃturdi
يايلاقلاردا	jajlaqlarda
يايلاقلارنى	jajlaqlarni
ياپونلارنىڭ	japonlarniŋ
ياڭراتقۇدىن	jaŋratqudin
يوشۇرۇدىغان	joʃurudiʁan
يوغان–يوغان	joʁan–joʁan
يوقىلۋاتقان	joqilwatqan
يوپۇرماقلار	jopurmaqlar
يىغلاۋاتقان	jiʁlawatqan
يىغلىغىنىچە	jiʁliʁinit͡ʃɛ
يىغىلغانىدى	jiʁilʁanidi
يىگىتۋېشىغا	jiɡitweʃiʁa
يۆتكەيدىكەن	jøtkɛjdikɛn
يۇرتىمىزدىن	jurtimizdin
يۇرتىمىزنىڭ	jurtimizniŋ
يۇقىرىقىلار	juqiriqilar
يۇلتۇزلارغا	jultuzlarʁa
يۇلقۇنۇۋىدى	julqunuwidi
يۇممىغانىدى	jummiʁanidi
يۇمۇۋالاتتى	jumuwalatti
يۈزلىنىشىگە	jyzliniʃiɡɛ
يۈگۈرگىنىچە	jyɡyrɡinit͡ʃɛ
يۈگۈرگەندەك	jyɡyrɡɛndɛk
يۈگۈرۈدىغان	jyɡyrydiʁan
يۈگۈرۈشۈپتۇ	jyɡyryʃyptu
يېتىشتۈرگەن	jetiʃtyrɡɛn
يېتىشىۋېلىپ	jetiʃiwelip
يېتەكلىگۈچى	jetɛkliɡyt͡ʃi
يېزىلغانىدى	jezilʁanidi
يېنىكلىتىدۇ	jeniklitidu
يېنىۋاتاتتى	jeniwatatti
يېڭىلگىنىگە	jeŋilɡiniɡɛ
يەلپۈگۈچتەك	jɛlpyɡyt͡ʃtɛk
يەۋاتىسىزغۇ	jɛwatisizʁu
پاراسىتىنىڭ	parasitiniŋ
پارتلاتقىلى	partlatqili
پاكىزلاردىن	pakizlardin
پالتىلىرىغا	paltiliriʁa
پالتىلىرىنى	paltilirini
پايتەختتىكى	pajtɛχttiki
پوشتىخانىغا	poʃtiχaniʁa
پىرىنسىپىنى	pirinsipini
پىكىرلەشكەن	pikirlɛʃkɛn
پىچىرلايتتى	pit͡ʃirlajtti
پۇرىيالىدۇق	purijaliduq
پۇقرالارنىڭ	puqralarniŋ
پۈركىۋالغان	pyrkiwalʁan
پۈۋلەپتىكەن	pywlɛptikɛn
پەخىرلەنگەن	pɛχirlɛnɡɛn
پەرۋەردىگاھ	pɛrwɛrdiɡah
پەزىلەتلىرى	pɛzilɛtliri
پەن–تېخنىكا	pɛn–teχnika
پەۋقۇلئاددە	pɛwquladdɛ
چاغلىرىدىمۇ	t͡ʃaʁliridimu
چاقپەلەكتەك	t͡ʃaqpɛlɛktɛk
چاقپەلەكنىڭ	t͡ʃaqpɛlɛkniŋ
چاندۇرماپتۇ	t͡ʃandurmaptu
چاپانلىرىنى	t͡ʃapanlirini
چىرىغىمىزنى	t͡ʃiriʁimizni
چىشلىگىنىچە	t͡ʃiʃliɡinit͡ʃɛ
چىقارمايتتى	t͡ʃiqarmajtti
چىققاندەكلا	t͡ʃiqqandɛkla
چىقمايدىغان	t͡ʃiqmajdiʁan
چىقىرىدىكەن	t͡ʃiqiridikɛn
چىقىۋېتىپتۇ	t͡ʃiqiwetiptu
چىلىق–چىلىق	t͡ʃiliq–t͡ʃiliq
چىنپۈتمەيدۇ	t͡ʃinpytmɛjdu
چۆچۈتۈۋەتتى	t͡ʃøt͡ʃytywɛtti
چۈشۈرىۋېتىپ	t͡ʃyʃyriwetip
چېلىۋېرەمدۇ	t͡ʃeliwerɛmdu
چەكلەنمەيدۇ	t͡ʃɛklɛnmɛjdu
چەۋەندازلار	t͡ʃɛwɛndazlar
ژۇرناللارنى	ʒurnallarni
گۈدەكلىكىنى	ɡydɛklikini
گۈزەللىكىنى	ɡyzɛllikini
گۈزەللىكىگە	ɡyzɛllikiɡɛ
گۈلزارلىققا	ɡylzarliqqa
گۈللەندۈرۈش	ɡyllɛndyryʃ
گېزىتىمىزگە	ɡezitimizɡɛ
ھادىسىلەرنى	hadisilɛrni
ھارغىنلىقنى	harʁinliqni
ھارۋىكەشنىڭ	harwikɛʃniŋ
ھاياتلىقتىن	hajatliqtin
ھاياتلىقنىڭ	hajatliqniŋ
ھاياتىمدىكى	hajatimdiki
ھاياتىمىزدا	hajatimizda
ھايۋاندىنمۇ	hajwandinmu
ھايۋانلارمۇ	hajwanlarmu
ھايۋانلارنى	hajwanlarni
ھاۋارايىنىڭ	hawarajiniŋ
ھۆكۈمرانلىق	høkymranliq
ھېسابلىنىدۇ	hesablinidu
ھېساپلىنىدۇ	hesaplinidu
ھېسسىياتىغا	hessijatiʁa
ھېسسياتىمىز	hessjatimiz
ھېكايىلەرنى	hekajilɛrni
ھېچقايسىمىز	het͡ʃqajsimiz
ھېچنىمىسىنى	het͡ʃnimisini
ھەركەتلەرنى	hɛrkɛtlɛrni
ھەرىكىتىدىن	hɛrikitidin
ھەرىكىتىنىڭ	hɛrikitiniŋ
ھەقىقەتەنمۇ	hɛqiqɛtɛnmu
ھەمكارلىشىپ	hɛmkarliʃip
ھەممەيلەننى	hɛmmɛjlɛnni
ھەممەيلەنگە	hɛmmɛjlɛnɡɛ
ھەيدىگۈڭلار	hɛjdiɡyŋlar
ھەيرانلىقتا	hɛjranliqta
ھەپتىيەكتىن	hɛptijɛktin
ھەپىلىشىپتۇ	hɛpiliʃiptu
ۋارقىرىشىمۇ	warqiriʃimu
ۋەتىنىمىزنى	wɛtinimizni
ۋەزىرلىرىمۇ	wɛzirlirimu
ئىھتىياجلىق_بولماقتا	ihtijad͡ʒliq_bolmaqta
ئاتلىقلارنىڭ	atliqlarniŋ
ئادەتتىكىدەك	adɛttikidɛk
ئارستوتېلنىڭ	arstotelniŋ
ئارلىقىدىنمۇ	arliqidinmu
ئاغرىۋاتامدۇ	aʁriwatamdu
ئالاتتىڭىزمۇ	alattiŋizmu
ئالاھىدىلىكى	alahidiliki
ئالدىغانىكەن	aldiʁanikɛn
ئاياغلاشقۇچە	ajaʁlaʃqut͡ʃɛ
ئاياللىرىنىڭ	ajalliriniŋ
ئايرىلىدىغان	ajrilidiʁan
ئايرىلىدىكەن	ajrilidikɛn
ئايلانغانىدى	ajlanʁanidi
ئايىمايدىكەن	ajimajdikɛn
ئاپارغانلىقى	aparʁanliqi
ئاڭلاۋاتاتتى	aŋlawatatti
ئاڭلىيالايدۇ	aŋlijalajdu
ئاڭلىيالىدۇق	aŋlijaliduq
ئشلىتىلمەكتە	eʃlitilmɛktɛ
ئوبرازلاشقان	obrazlaʃqan
ئورۇندۇقۇڭنى	orunduquŋni
ئورۇنلىرىدىن	orunliridin
ئوغلاقچىلىرى	oʁlaqt͡ʃiliri
ئوقۇتقۇچىلار	oqutqut͡ʃilar
ئولتۇرغاندىن	olturʁandin
ئولتۇرغىنىچە	olturʁinit͡ʃɛ
ئولتۇرىدىغان	olturidiʁan
ئولتۇرىدىكەن	olturidikɛn
ئولتۇرۇرۇپتۇ	oltururuptu
ئولتۇرۇۋېلىپ	olturuwelip
ئولتۇرۇۋەردى	olturuwɛrdi
ئويلانغاندىن	ojlanʁandin
ئويلاۋاتىمەن	ojlawatimɛn
ئويلىغىنىمدا	ojliʁinimda
ئويمانلىقنىڭ	ojmanliqniŋ
ئويناۋاتاتتى	ojnawatatti
ئويناۋېتىپتۇ	ojnawetiptu
ئىتالىيىدىكى	italijidiki
ئىتتىرىۋېتىپ	ittiriwetip
ئىتتىپاقىنىڭ	ittipaqiniŋ
ئىرغاڭلايتتى	irʁaŋlajtti
ئىزدەۋاتاتتى	izdɛwatatti
ئىسپاتلانغان	ispatlanʁan
ئىشخانىسىنىڭ	iʃχanisiniŋ
ئىشلىتىدىغان	iʃlitidiʁan
ئىشلىگەنلىكى	iʃliɡɛnliki
ئىشلەتكەندىن	iʃlɛtkɛndin
ئىشلەۋېرىپتۇ	iʃlɛweriptu
ئىغاڭلىماقتا	iʁaŋlimaqta
ئىقتىدارىمنى	iqtidarimni
ئىقتىدارىنىڭ	iqtidariniŋ
ئىككىڭلارنىڭ	ikkiŋlarniŋ
ئىكەنلىكىمنى	ikɛnlikimni
ئىلىم–پەننىڭ	ilim–pɛnniŋ
ئىلگىرىكىدەك	ilɡirikidɛk
ئىنسانلارنىڭ	insanlarniŋ
ئۆتكۈزۈلۈپتۇ	øtkyzylyptu
ئۆتۈۋاتقاندا	øtywatqanda
ئۆزگەرتمەكتە	øzɡɛrtmɛktɛ
ئۆسمۈرلۈكنىڭ	øsmyrlykniŋ
ئۆسەلەيدىكەن	øsɛlɛjdikɛn
ئۆلكىلەردىكى	ølkilɛrdiki
ئۆيلەنگەندىن	øjlɛnɡɛndin
ئۆچۈرگۈچۈمنى	øt͡ʃyrɡyt͡ʃymni
ئۆگىنىۋاتقان	øɡiniwatqan
ئۆگىنىۋالدىم	øɡiniwaldim
ئۇخلىيالايدۇ	uχlijalajdu
ئۇزاتقۇچىلار	uzatqut͡ʃilar
ئۇزۇنلۇقتىكى	uzunluqtiki
ئۇسسۇزلۇقنىڭ	ussuzluqniŋ
ئۇيغۇرلارنىڭ	ujʁurlarniŋ
ئۇيۇشتۇرۇلدى	ujuʃturuldi
ئۇچۇۋېتىپىتۇ	ut͡ʃuwetipitu
ئېتىزلاردىكى	etizlardiki
ئېتىزلىقتىكى	etizliqtiki
ئېرىشەلمىگەن	eriʃɛlmiɡɛn
ئېرىشەلەيسىز	eriʃɛlɛjsiz
ئېغىرلىقتىكى	eʁirliqtiki
ئېكىسكۇرسىيە	ekiskursijɛ
ئېلىۋېتىلگەن	eliwetilɡɛn
ئېيتىدۇلەركى	ejtidulɛrki
ئېچىۋەتمەكچى	et͡ʃiwɛtmɛkt͡ʃi
ئەخمەقلىقىنى	ɛχmɛqliqini
ئەدەپ–ئەخلاق	ɛdɛp–ɛχlaq
ئەركىلىشەتتى	ɛrkiliʃɛtti
ئەقىدىلىرىنى	ɛqidilirini
ئەمەلىيىتىدە	ɛmɛlijitidɛ
ئەمەلىيىتىنى	ɛmɛlijitini
ئەنگىلىيىلىك	ɛnɡilijilik
بارالايدىغان	baralajdiʁan
بارلىقىمىزنى	barliqimizni
باشقۇرغۇچىسى	baʃqurʁut͡ʃisi
باغۋەنلەرنىڭ	baʁwɛnlɛrniŋ
باقمىغانىدىڭ	baqmiʁanidiŋ
باكتېرىيىلەر	bakterijilɛr
باھالايدىغان	bahalajdiʁan
بولغانلىقتىن	bolʁanliqtin
بولغانلىقىنى	bolʁanliqini
بولمىغانىكەن	bolmiʁanikɛn
بويتاقلاردىن	bojtaqlardin
بىلىدىغانلار	bilidiʁanlar
بىلىۋېلىڭلار	biliweliŋlar
بېرەلەيدىغان	berɛlɛjdiʁan
بېغىشلايتتىڭ	beʁiʃlajttiŋ
بېلىجانلارنى	belid͡ʒanlarni
بەرگەنلىكىنى	bɛrɡɛnlikini
بەلۋاغلاردەك	bɛlwaʁlardɛk
تاتلىقلىقىنى	tatliqliqini
تارقىتىلمىدى	tarqitilmidi
تورغايلارنىڭ	torʁajlarniŋ
توزغاقلىرىنى	tozʁaqlirini
توقۇمىچىلىرى	toqumit͡ʃiliri
تىرىشچانلىقى	tiriʃt͡ʃanliqi
تىرىڭشىتاتتى	tiriŋʃitatti
تىكىلگىنىمدە	tikilɡinimdɛ
تىكىۋاپسەنغۇ	tikiwapsɛnʁu
تىمتاسلىقتىن	timtasliqtin
تۇتاشتۇرۇلۇپ	tutaʃturulup
تۇتۇۋالالماي	tutuwalalmaj
تۇرامدىغاندۇ	turamdiʁandu
تۈگىمەيدىغان	tyɡimɛjdiʁan
تېتىيالمايدۇ	tetijalmajdu
تېرىككىنىدىن	terikkinidin
تېمپېراتۇرسى	temperatursi
تەتقىقاتىنىڭ	tɛtqiqatiniŋ
تەجرىبىلەرنى	tɛd͡ʒribilɛrni
تەجىرىبىسىنى	tɛd͡ʒiribisini
تەربىيىسىنىڭ	tɛrbijisiniŋ
تەربىيىلەرنى	tɛrbijilɛrni
تەرەققىياتقا	tɛrɛqqijatqa
تەشكىلاتىنىڭ	tɛʃkilatiniŋ
تەشكىللىنىشى	tɛʃkilliniʃi
تەقەززالىقتا	tɛqɛzzaliqta
تەكرارلايتتى	tɛkrarlajtti
تەييارلىنىدۇ	tɛjjarlinidu
تەڭرىتېغىدىن	tɛŋriteʁidin
تەڭلاۋاتاتتى	tɛŋlawatatti
تەۋرىنىشىدىن	tɛwriniʃidin
تەۋرىنۋاتقان	tɛwrinwatqan
جايلاشقانىدى	d͡ʒajlaʃqanidi
جاھازىلىرىغا	d͡ʒahaziliriʁa
خاراكتېردىكى	χarakterdiki
خاراكتېرىدىن	χarakteridin
خالىمايدىكەن	χalimajdikɛn
خوشاللىقىمنى	χoʃalliqimni
خۇشاللىقىدىن	χuʃalliqidin
خەلقارالاشسا	χɛlqaralaʃsa
داۋاملىشاتتى	dawamliʃatti
دوختۇرخانىدا	doχturχanida
دوختۇرخانىغا	doχturχaniʁa
دىزىنفىكسىيە	dizinfiksijɛ
دۇنيايىمىزمۇ	dunjajimizmu
دېكلاماتسىيە	deklamatsijɛ
دېيىشكەنىدۇق	dejiʃkɛniduq
دېگەنلىرىڭىز	deɡɛnliriŋiz
دېھقانلارنىڭ	dehqanlarniŋ
دەرسخانىدىكى	dɛrsχanidiki
دەرىسلىكلىرى	dɛrislikliri
دەرياسى››نىڭ	dɛrjasi››niŋ
دەرۋازىسىنىڭ	dɛrwazisiniŋ
دەستىگاھتىكى	dɛstiɡahtiki
دەستۇرلىرىنى	dɛsturlirini
رايونلىرىنىڭ	rajonliriniŋ
رايونىمىزنىڭ	rajonimizniŋ
رىۋايەتلەرگە	riwajɛtlɛrɡɛ
رىۋايەتچىلەر	riwajɛtt͡ʃilɛr
زامانىمىزنىڭ	zamanimizniŋ
زىرائەتلەرنى	ziraɛtlɛrni
زىننەتلەنگەن	zinnɛtlɛnɡɛn
ساغلاملىقىغا	saʁlamliqiʁa
ساقال–بۇرۇتى	saqal–buruti
سالامەتلىكىم	salamɛtlikim
سايراۋېتىپتۇ	sajrawetiptu
سايىۋەنلەرمۇ	sajiwɛnlɛrmu
ساۋاقداشلىرى	sawaqdaʃliri
ساۋاقدىشىنىڭ	sawaqdiʃiniŋ
سىنىپىمىزنىڭ	sinipimizniŋ
سۆيگىنىمىكىن	søjɡinimikin
سۇندۇرىۋېلىپ	sunduriwelip
سۈرتۈلگەندىن	syrtylɡɛndin
سۈزۈكلىكىدىن	syzyklikidin
سۈمۈرىۋالىدۇ	symyriwalidu
سۈپۈرۈۋاتقان	sypyrywatqan
سېلىنمىسىدىن	selinmisidin
سېمونتلانغان	semontlanʁan
سېمىزلىكىدىن	semizlikidin
سەنئەتكارلار	sɛnɛtkarlar
شارىنىڭكىدىن	ʃariniŋkidin
شاپتۇللارنىڭ	ʃaptullarniŋ
شۆلگەيلىرىنى	ʃølɡɛjlirini
شەكىللىرىنىڭ	ʃɛkilliriniŋ
قابىلىيەتلىك	qabilijɛtlik
قارىلىدىغىنى	qarilidiʁini
قارىياغاچلار	qarijaʁat͡ʃlar
قازىدىغانلار	qazidiʁanlar
قاقالمايتتىم	qaqalmajttim
قالارلىقمىدۇ	qalarliqmidu
قالدۇرىدىغان	qalduridiʁan
قالغانلىرىنى	qalʁanlirini
قالغانلىقىنى	qalʁanliqini
قالىدىكەنمەن	qalidikɛnmɛn
قانائەتلىنىپ	qanaɛtlinip
قانداقلىقىنى	qandaqliqini
قايرىشىشىڭغا	qajriʃiʃiŋʁa
قايغۇ–ھەسرەت	qajʁu–hɛsrɛt
قوغلىشىدىغان	qoʁliʃidiʁan
قولتۇقلىرىنى	qoltuqlirini
قوناقلىرىنىڭ	qonaqliriniŋ
قويغىنىمىزدا	qojʁinimizda
قىزىقىشتىنمۇ	qiziqiʃtinmu
قىستۇرۇۋاپتۇ	qisturuwaptu
قىلالايدىغان	qilalajdiʁan
قىلالايدىكەن	qilalajdikɛn
قىلالمىغۇدەك	qilalmiʁudɛk
قىلىدىغانلار	qilidiʁanlar
قۇتقۇزۇۋالدى	qutquzuwaldi
قۇرۇقلۇقىنىڭ	quruqluqiniŋ
قۇرۇلۇشىدىكى	quruluʃidiki
قۇشقاچلىرىغا	quʃqat͡ʃliriʁa
قۇيۇلۇۋاتقان	qujuluwatqan
قۇۋزاقلىرىنى	quwzaqlirini
قېرىنداشلىرى	qerindaʃliri
قەلبىمىزدىكى	qɛlbimizdiki
قەلبىڭدىكىلا	qɛlbiŋdikila
قەلەمدېنىمغا	qɛlɛmdenimʁa
قەيەلەرگىدۇر	qɛjɛlɛrɡidur
كارىزلىرىنىڭ	karizliriniŋ
كولىغۇچتەكلا	koliʁut͡ʃtɛkla
كىتابلىرىمنى	kitablirimni
كىرلىكلىرىمۇ	kirliklirimu
كىرگۈزۈلۈپتۇ	kirɡyzylyptu
كىرگۈزۈۋېتىڭ	kirɡyzywetiŋ
كىلومېتىردىن	kilometirdin
كىيىدىغاندەك	kijidiʁandɛk
كىيىشىۋالغان	kijiʃiwalʁan
كىيىملىرىمنى	kijimlirimni
كىيىملىرىنىڭ	kijimliriniŋ
كىچىكلىكىمدە	kit͡ʃiklikimdɛ
كۆتۈرۈۋالغان	køtyrywalʁan
كۆرگەزمىسىنى	kørɡɛzmisini
كۆرگەزمىسىگە	kørɡɛzmisiɡɛ
كۆرۈنمىگىدەك	kørynmiɡidɛk
كۆرۈنۈشلەرنى	kørynyʃlɛrni
كۆرۈۋاتاتتىم	kørywatattim
كۆرەلمىدىمغۇ	kørɛlmidimʁu
كۆپۈكچىلەرگە	køpykt͡ʃilɛrɡɛ
كۆپەيگەنسىرى	køpɛjɡɛnsiri
كۆڭلۈمدىكىنى	køŋlymdikini
كۆڭۈللىرىمىز	køŋyllirimiz
كۈلدۈرىدىغان	kyldyridiʁan
كۈلۈمسىرىگەن	kylymsiriɡɛn
كۈندىن–كۈنگە	kyndin–kynɡɛ
كۈچۈكلىرىنىڭ	kyt͡ʃykliriniŋ
كېتىپتىمەنكى	ketiptimɛnki
كېتىۋاتقاندا	ketiwatqanda
كېلىشىۋاتىدۇ	keliʃiwatidu
كېلىۋاتقاندا	keliwatqanda
كېچەكلىرىمنى	ket͡ʃɛklirimni
كېۋەزلىكتىكى	kewɛzliktiki
كەتكەنلىكىنى	kɛtkɛnlikini
كەشپىياتلىرى	kɛʃpijatliri
كەشپىياتچىنڭ	kɛʃpijatt͡ʃinŋ
كەلگەنلىكدىن	kɛlɡɛnlikdin
كەلگەنلىكىنى	kɛlɡɛnlikini
كەنتىمىزدىكى	kɛntimizdiki
كەچقۇرۇنلۇقى	kɛt͡ʃqurunluqi
كەچۈرگەنلىكى	kɛt͡ʃyrɡɛnliki
لېگەنچىلىكلا	leɡɛnt͡ʃilikla
لەگلەكلەرنىڭ	lɛɡlɛklɛrniŋ
ماتېماتىكلار	matematiklar
ماتېماتىكىغا	matematikiʁa
مارجانبۇلىقى	mard͡ʒanbuliqi
ماركىللىرىغا	markilliriʁa
موللاشتۇرغان	mollaʃturʁan
مۆكۈنۈۋالغان	møkynywalʁan
مۇئەللىمىدىن	muɛllimidin
مۇتەخسسىسلەر	mutɛχssislɛr
مۇتەخەسىسلەر	mutɛχɛsislɛr
مۇددىئاسىدىن	muddiasidin
مۇزلۇقلارنىڭ	muzluqlarniŋ
مۇسابىقىدىكى	musabiqidiki
مۇكەممەللىكى	mukɛmmɛlliki
مۇناسىۋەتلىك	munasiwɛtlik
مۈشۈكياپىلاق	myʃykjapilaq
مېتېئورىتلار	meteoritlar
مېۋەزارلىقتا	mewɛzarliqta
مەجنۇنتاللار	mɛd͡ʒnuntallar
مەدەنىيىتىمۇ	mɛdɛnijitimu
مەدەنىيىتىنى	mɛdɛnijitini
مەزگىلىڭدىلا	mɛzɡiliŋdila
مەشرىپى››نىڭ	mɛʃripi››niŋ
مەشرەپلەرنىڭ	mɛʃrɛplɛrniŋ
مەكتىپىمىزدە	mɛktipimizdɛ
مەكتەپلەرنىڭ	mɛktɛplɛrniŋ
مەمنۇنيىتىنى	mɛmnunjitini
مەيدانلىرىدا	mɛjdanlirida
مەھەللىسىدىن	mɛhɛllisidin
مەھەللىمىزنى	mɛhɛllimizni
مەھەللىڭىزدە	mɛhɛlliŋizdɛ
نارازىلىقىنى	naraziliqini
نامراتلىقنىڭ	namratliqniŋ
ناھىيىمىزنىڭ	nahijimizniŋ
نۇرغۇنلىرىدا	nurʁunlirida
نۇسخىلىرىدىن	nusχiliridin
نېمىلەرنىدۇر	nemilɛrnidur
نەتىجىلىرىگە	nɛtid͡ʒiliriɡɛ
ياتقۇزۇلۇپتۇ	jatquzuluptu
ياردەملەشتىم	jardɛmlɛʃtim
يازغىنىڭىزنى	jazʁiniŋizni
ياساتقانىدىم	jasatqanidim
ياسىلىۋاتقان	jasiliwatqan
ياققانلىقىنى	jaqqanliqini
ياللىۋېلىشنى	jalliweliʃni
يالپۇزلاردىن	jalpuzlardin
ياندۇرمايمەن	jandurmajmɛn
يانچۇقلىرىنى	jant͡ʃuqlirini
يوقسۇزلۇقتىن	joqsuzluqtin
يوقلىغۇچىلار	joqliʁut͡ʃilar
يوپۇرماقلىرى	jopurmaqliri
يوچۇقلىرىدىن	jot͡ʃuqliridin
يىغىلغانسېرى	jiʁilʁanseri
يۆتكىۋېتىمەن	jøtkiwetimɛn
يۇرتىمىزدىكى	jurtimizdiki
يۈكسەكلىكىدە	jyksɛklikidɛ
يۈگۈرەلەيسەن	jyɡyrɛlɛjsɛn
يېتىلىگىنىچە	jetiliɡinit͡ʃɛ
يېزىۋاتقاندا	jeziwatqanda
يېمەك–ئىچمەك	jemɛk–it͡ʃmɛk
يېڭىۋالمىسام	jeŋiwalmisam
يەرمەنكسىىنى	jɛrmɛnksiini
يەرمەنكىسىگە	jɛrmɛnkisiɡɛ
يەكۈنلەيتتۇق	jɛkynlɛjttuq
يەۋاتقانىكەن	jɛwatqanikɛn
پائالىيىتىنى	paalijitini
پائالىيىتىگە	paalijitiɡɛ
پاراۋۇزلارنى	parawuzlarni
پارلاقلىقىنى	parlaqliqini
پاھادىشاھلار	pahadiʃahlar
پېتىنالماپتۇ	petinalmaptu
پەخىرلىنىمىز	pɛχirlinimiz
پەرقلەنمىگەن	pɛrqlɛnmiɡɛn
پەزىلىتىنىمۇ	pɛzilitinimu
چاقلىرىنىڭمۇ	t͡ʃaqliriniŋmu
چىدىيالمىدۇق	t͡ʃidijalmiduq
چىقىرالمىدىم	t͡ʃiqiralmidim
چىمىلدىتاتتى	t͡ʃimilditatti
چىيۇۋچىمىڭمۇ	t͡ʃijuwt͡ʃimiŋmu
چۆرگىلەيتتۇق	t͡ʃørɡilɛjttuq
چۇرقىرىشىپتۇ	t͡ʃurqiriʃiptu
چۈشىنەلمىگەن	t͡ʃyʃinɛlmiɡɛn
چۈشىنەلمەپتۇ	t͡ʃyʃinɛlmɛptu
چۈشۈرۈۋاتقان	t͡ʃyʃyrywatqan
چۈشۈرۈۋەتكەن	t͡ʃyʃyrywɛtkɛn
چۈشۈندۈرۈپتۇ	t͡ʃyʃyndyryptu
چۈشۈۋاتقاندا	t͡ʃyʃywatqanda
چۈشەندۈرگۈچى	t͡ʃyʃɛndyrɡyt͡ʃi
چۈمۈلىلەردەك	t͡ʃymylilɛrdɛk
چەكلىنىدىغان	t͡ʃɛklinidiʁan
چەۋەندازلىرى	t͡ʃɛwɛndazliri
گالىستۇكىدىن	ɡalistukidin
گۇرۇپپىسىدىن	ɡuruppisidin
ھازىرلىغاندا	hazirliʁanda
ھاشاراتلارنى	haʃaratlarni
ھاياجانلىنىپ	hajad͡ʒanlinip
ھايۋانلاردەك	hajwanlardɛk
ھايۋانلارنىڭ	hajwanlarniŋ
ھۆسنخەتچىلەپ	høsnχɛtt͡ʃilɛp
ھېسابلىغاندا	hesabliʁanda
ھېسابلىنىسەن	hesablinisɛn
ھېكايىلىرىغا	hekajiliriʁa
ھېچقايسىسىغا	het͡ʃqajsisiʁa
ھەرىكەتلەرنى	hɛrikɛtlɛrni
ھەمراھلىرىمۇ	hɛmrahlirimu
ھەپلىشىدىغان	hɛpliʃidiʁan
ۋارقىرىشاتتى	warqiriʃatti
ۋاشىنگتوننىڭ	waʃinɡtonniŋ
ۋاگونلاردىكى	waɡonlardiki
ۋىچىرلىشاتتى	wit͡ʃirliʃatti
ۋېلىسىپىتىنى	welisipitini
ئائىلىدىكىلەر	ailidikilɛr
ئاخىرلاشتۇرسا	aχirlaʃtursa
ئاخىرلاشقاندا	aχirlaʃqanda
ئادەتتىكىلىرى	adɛttikiliri
ئادەمكەنمەندە	adɛmkɛnmɛndɛ
ئادەملەرنىڭلا	adɛmlɛrniŋla
ئارلىقلىرىدىن	arliqliridin
ئارىستوتېلنىڭ	aristotelniŋ
ئالاھىدىلىككە	alahidilikkɛ
ئالماشتۇراتتى	almaʃturatti
ئالماشتۇرغىلى	almaʃturʁili
ئالماشتۇرۇشقا	almaʃturuʃqa
ئاينىۋاتقاندا	ajniwatqanda
ئاپتوموبىللار	aptomobillar
ئاڭلاشقانىكەن	aŋlaʃqanikɛn
ئاڭلىدىڭلارمۇ	aŋlidiŋlarmu
ئاڭلىماقتىمىز	aŋlimaqtimiz
ئاڭلىمايدىكەن	aŋlimajdikɛn
ئاڭلىنىۋاتقان	aŋliniwatqan
ئاگاھلاندۇرۇپ	aɡahlandurup
ئاۋارىچىلىككە	awarit͡ʃilikkɛ
ئاۋۋالقىدەكلا	awwalqidɛkla
ئوتتۇرىسىدىكى	otturisidiki
ئورمانلىقتىكى	ormanliqtiki
ئورىۋالغىنىچە	oriwalʁinit͡ʃɛ
ئورۇندۇقۇمدىن	orunduqumdin
ئوقۇتقۇچىلىرى	oqutqut͡ʃiliri
ئوقۇغىنىڭىزدا	oquʁiniŋizda
ئولتۇرۇپتىمىز	olturuptimiz
ئولتۇرۇۋەردىم	olturuwɛrdim
ئومۇمىيلىقىغا	omumijliqiʁa
ئويۇنچۇقلارنى	ojunt͡ʃuqlarni
ئىسراپچىلىققا	israpt͡ʃiliqqa
ئىشلەپچىقىرىش	iʃlɛpt͡ʃiqiriʃ
ئىشلەۋاتقىدەك	iʃlɛwatqidɛk
ئىغاڭلىغىنىچە	iʁaŋliʁinit͡ʃɛ
ئىمكانىيىتىگە	imkanijitiɡɛ
ئىمكانىيەتنىڭ	imkanijɛtniŋ
ئىنسانىيەتنىڭ	insanijɛtniŋ
ئىپتىخارلىنىش	iptiχarliniʃ
ئۆتكۈزۈۋالىدۇ	øtkyzywalidu
ئۆزگىرەلەيمەن	øzɡirɛlɛjmɛn
ئۆسۈملۈكلەرمۇ	øsymlyklɛrmu
ئۆسۈملۈكلەرنى	øsymlyklɛrni
ئۆسۈملۈكلەرگە	øsymlyklɛrɡɛ
ئۇششاق–چۈششەك	uʃʃaq–t͡ʃyʃʃɛk
ئۇيغۇرلىرىنىڭ	ujʁurliriniŋ
ئۇچۇرۇۋېتىپتۇ	ut͡ʃuruwetiptu
ئۈزۈۋاتقاندەك	yzywatqandɛk
ئېرىشتۈرمەكچى	eriʃtyrmɛkt͡ʃi
ئېسىۋالىدىغان	esiwalidiʁan
ئېغىرچىلىقىنى	eʁirt͡ʃiliqini
ئېلىكتىرونلوق	eliktironloq
ئېلېكتىرونلۇق	elektironluq
ئېيتقانلىرىنى	ejtqanlirini
ئەتراپتىكىلەر	ɛtraptikilɛr
ئەجدادلىرىمىز	ɛd͡ʒdadlirimiz
ئەركىنجاننىمۇ	ɛrkind͡ʒannimu
ئەستايىدىللىق	ɛstajidilliq
ئەسەرلىرىدىكى	ɛsɛrliridiki
ئەمەلىيەتتىمۇ	ɛmɛlijɛttimu
ئەنسىرەيدىكەن	ɛnsirɛjdikɛn
باراۋەرلىگىنى	barawɛrliɡini
بالىلىرىمىزنى	balilirimizni
بايقىيالايسىز	bajqijalajsiz
بولغانلىقىدىن	bolʁanliqidin
بولغۇچىلارنىڭ	bolʁut͡ʃilarniŋ
بېرىلمەيدىغان	berilmɛjdiʁan
بېرىۋاتقاندەك	beriwatqandɛk
بېرەلمەيدىكەن	berɛlmɛjdikɛn
تاشلىماقتىمىز	taʃlimaqtimiz
تاشلىۋەتكۈمىز	taʃliwɛtkymiz
تاكاللىشىشىغا	takalliʃiʃiʁa
تاپشۇرىۋالىدۇ	tapʃuriwalidu
تراكتۇرلارنىڭ	trakturlarniŋ
تونۇشتۇرماقچى	tonuʃturmaqt͡ʃi
تونۇشتۇرۇشىچە	tonuʃturuʃit͡ʃɛ
تونۇشۇۋالىمىز	tonuʃuwalimiz
تىياتىرخانىسى	tijatirχanisi
تىپىرلىغىنىچە	tipirliʁinit͡ʃɛ
تۈسكىلىرىڭلار	tyskiliriŋlar
تۈنۈگۈنىمىزنى	tynyɡynimizni
تۈگىگەنلىكىنى	tyɡiɡɛnlikini
تېرىقچىلىقىنى	teriqt͡ʃiliqini
تېگىشمەيدىغان	teɡiʃmɛjdiʁan
تەبرىكلەشلىرى	tɛbriklɛʃliri
تەتقىقاتلارنى	tɛtqiqatlarni
تەجرىبىخانىدا	tɛd͡ʒribiχanida
تەجرىبىلىرىنى	tɛd͡ʒribilirini
تەجرىبىلەرنىڭ	tɛd͡ʒribilɛrniŋ
تەرەققىياتنىڭ	tɛrɛqqijatniŋ
تەرەققىياتىغا	tɛrɛqqijatiʁa
تەرەققىياتىمۇ	tɛrɛqqijatimu
تەستىقلىنىشتا	tɛstiqliniʃta
تەسىراتىمىزنى	tɛsiratimizni
تەسەۋۋۇرلارنى	tɛsɛwwurlarni
تەشكىللىنەتتى	tɛʃkillinɛtti
تەڭرىتېغىدىكى	tɛŋriteʁidiki
تەڭپۇڭسىزلىقى	tɛŋpuŋsizliqi
تەۋرىنىۋاتقان	tɛwriniwatqan
جاكارلايمەنكى	d͡ʒakarlajmɛnki
جايلاشقانلىقى	d͡ʒajlaʃqanliqi
جەزىملەشتۈرۈپ	d͡ʒɛzimlɛʃtyryp
خاتالاشقىنىنى	χatalaʃqinini
خاراكتېرىدىكى	χarakteridiki
خىتايچىسىنىمۇ	χitajt͡ʃisinimu
خىزمەتچىسىدەك	χizmɛtt͡ʃisidɛk
خۇشاللىقلارغا	χuʃalliqlarʁa
داۋاملاشتۇردى	dawamlaʃturdi
دوختۇرخاندىكى	doχturχandiki
دوختۇرخانىنىڭ	doχturχaniniŋ
دەستىگاھلارنى	dɛstiɡahlarni
دەپتەرلىرىمنى	dɛptɛrlirimni
رېئاللىقىدىكى	realliqidiki
زەينىدىندەكلا	zɛjnidindɛkla
ساتىراشخانىدا	satiraʃχanida
ساقلاپ–ساقلاپ	saqlap–saqlap
سالاملاشماقتا	salamlaʃmaqta
ساۋاقداشلارغا	sawaqdaʃlarʁa
سوقۇۋەتكەندەك	soquwɛtkɛndɛk
سىزەلمەيدىغان	sizɛlmɛjdiʁan
سۆزلىيەلمىسەڭ	søzlijɛlmisɛŋ
سۆيدۈرەلمەيدۇ	søjdyrɛlmɛjdu
سېستىرالارنىڭ	sestiralarniŋ
سەكرىلەيدىكەن	sɛkrilɛjdikɛn
سەنمىنجۇيىنىڭ	sɛnmind͡ʒujiniŋ
سەييارىلىرىنى	sɛjjarilirini
سەييارىلەردەك	sɛjjarilɛrdɛk
شاگىرىتلىرىنى	ʃaɡiritlirini
شىلدىرلاشلىرى	ʃildirlaʃliri
غىزالىنىدىغان	ʁizalinidiʁan
فىلىملىرىدىكى	filimliridiki
قاتارلىقلارنى	qatarliqlarni
قاتناشقىنىمدا	qatnaʃqinimda
قاراۋاتقاندەك	qarawatqandɛk
قارلىغاچلارغا	qarliʁat͡ʃlarʁa
قارلىغاچلارنى	qarliʁat͡ʃlarni
قاندۇرالمايدۇ	qanduralmajdu
قايتۇرۇۋالساق	qajturuwalsaq
قاپلانغانىكەن	qaplanʁanikɛn
قوبۇلخانىسىدا	qobulχanisida
قوغدىيالمىدىم	qoʁdijalmidim
قوغدىيالمىساڭ	qoʁdijalmisaŋ
قونۇۋېلىشىدىن	qonuweliʃidin
قوياتتىڭىزكەن	qojattiŋizkɛn
قىلمىغاندىمەن	qilmiʁandimɛn
قىلىۋاتقاندەك	qiliwatqandɛk
قىلىۋېتىدىغان	qiliwetidiʁan
قىلىۋېلىشىمغا	qiliweliʃimʁa
قۇتقۇزۇۋالدىم	qutquzuwaldim
قۇتۇلالمايتتى	qutulalmajtti
قېينائانامنىڭ	qejnaanamniŋ
قەلەمتىرىچىنى	qɛlɛmtirit͡ʃini
كارخانىلاردىن	karχanilardin
كىلەلمەيدىغان	kilɛlmɛjdiʁan
كىيملىرىمىزنى	kijmlirimizni
كىيىمخانىسىدا	kijimχanisida
كۆرۈنمەيدىغان	kørynmɛjdiʁan
كۆرۈنمەيدىكەن	kørynmɛjdikɛn
كۆرۈۋاتقاندەك	kørywatqandɛk
كۆكلەۋاتقاندا	køklɛwatqanda
كۆڭلۈمدىكىدەك	køŋlymdikidɛk
كۈلكىلىرىڭنىڭ	kylkiliriŋniŋ
كۈلۈۋاتقىنىنى	kylywatqinini
كېتەلمەيدىكەن	ketɛlmɛjdikɛn
كېلىۋاتقىنىغا	keliwatqiniʁa
كېلەلمەيدىغان	kelɛlmɛjdiʁan
كېڭەيتىلمەكتە	keŋɛjtilmɛktɛ
كەشپىياتلارنى	kɛʃpijatlarni
كەلتۇرمەيىتتى	kɛlturmɛjitti
كەلتۈرگەنىكەن	kɛltyrɡɛnikɛn
كەلگۈچىلەرنىڭ	kɛlɡyt͡ʃilɛrniŋ
لۈكچەكلىرىنىڭ	lykt͡ʃɛkliriniŋ
ماتىرياللارنى	matirjallarni
مارجانبۇلاقتا	mard͡ʒanbulaqta
مارجانبۇلاقنى	mard͡ʒanbulaqni
مىدىرلىمايتتى	midirlimajtti
مىللەتلىرىنىڭ	millɛtliriniŋ
مۇتەخخەسىسلەر	mutɛχχɛsislɛr
مۇتەخەسىسسلەر	mutɛχɛsisslɛr
مۇتەپەككۇرلار	mutɛpɛkkurlar
مۇھاپىزەتچىسى	muhapizɛtt͡ʃisi
مەركەزلىرىدىن	mɛrkɛzliridin
مەستانىلىرىلا	mɛstanilirila
مەسلىھەتلىشىپ	mɛslihɛtliʃip
مەشرىپى››دىكى	mɛʃripi››diki
مەنزىرىلىرىنى	mɛnzirilirini
مەنزىرىلىرىگە	mɛnziriliriɡɛ
مەھەللىمىزنىڭ	mɛhɛllimizniŋ
نۇرغۇن–نۇرغۇن	nurʁun–nurʁun
ياتقۇزۇلغانغا	jatquzulʁanʁa
ياردەملىشىشكە	jardɛmliʃiʃkɛ
ياشاۋاتقاندەك	jaʃawatqandɛk
يالىڭاچلانىدى	jaliŋat͡ʃlanidi
ياپراقلىرىڭغا	japraqliriŋʁa
يوشۇرۇنغانىدى	joʃurunʁanidi
يوشۇرۇنۇۋېلىپ	joʃurunuwelip
يوپۇرماقلارنى	jopurmaqlarni
يىغلاپ–يىغلاپ	jiʁlap–jiʁlap
يىغلاۋەرسىڭىز	jiʁlawɛrsiŋiz
يۈگۈرۈۋېرىپتۇ	jyɡyryweriptu
يۈگۈرەلمەيمەن	jyɡyrɛlmɛjmɛn
يېتىلمەكتىمىز	jetilmɛktimiz
يېتەكچىلىكىدە	jetɛkt͡ʃilikidɛ
يېقىلغۇلارنىڭ	jeqilʁularniŋ
يېقىنلاشقاندا	jeqinlaʃqanda
يېنىۋالمايمىز	jeniwalmajmiz
يېڭىدىغانلىقى	jeŋidiʁanliqi
پائالىيىتىنىڭ	paalijitiniŋ
پاتقاقچىلىقنى	patqaqt͡ʃiliqni
پاراڭلاشماقتا	paraŋlaʃmaqta
پەيغەمبىرىمىز	pɛjʁɛmbirimiz
چاغلىمايدىغان	t͡ʃaʁlimajdiʁan
چوبگەزلىرىڭنى	t͡ʃobɡɛzliriŋni
چىرايلىقمىكەن	t͡ʃirajliqmikɛn
چېگىۋاتقاندەك	t͡ʃeɡiwatqandɛk
گەپ–سۆزلەرنىڭ	ɡɛp–søzlɛrniŋ
ھاشاراتلارنىڭ	haʃaratlarniŋ
ھاشارەتلەرنىڭ	haʃarɛtlɛrniŋ
ھاياجانلانغان	hajad͡ʒanlanʁan
ھېكايىسىدىنمۇ	hekajisidinmu
ھېچقايسىسىنىڭ	het͡ʃqajsisiniŋ
ھەرىكەتلىرىنى	hɛrikɛtlirini
ھەپىلەشكەندىن	hɛpilɛʃkɛndin
ۋاقىراشقىنىچە	waqiraʃqinit͡ʃɛ
ۋاكالەتچىسىنى	wakalɛtt͡ʃisini
ۋاپادارلىغىنى	wapadarliʁini
دارىلفۇنلىرىم»	darilfunlirim»
ئاجرىتىۋالغىلى	ad͡ʒritiwalʁili
ئاجرىتىۋېلىندى	ad͡ʒritiwelindi
ئارتۇقچىلىقىنى	artuqt͡ʃiliqini
ئارخىمىدلارنىڭ	arχimidlarniŋ
ئارىلاشتۇرۇپلا	arilaʃturupla
ئاقلىيالىغۇدەك	aqlijaliʁudɛk
ئالاھىدىلىكىمۇ	alahidilikimu
ئالدامچىلارنىڭ	aldamt͡ʃilarniŋ
ئالغىنىڭىزدىلا	alʁiniŋizdila
ئالۋاستىلارنىڭ	alwastilarniŋ
ئايروپىلاننىچۇ	ajropilannit͡ʃu
ئورۇنلاشتۇرۇشى	orunlaʃturuʃi
ئوقۇتقۇچىسىنىڭ	oqutqut͡ʃisiniŋ
ئوقۇغۇچىلاردىن	oquʁut͡ʃilardin
ئوقۇغۇچىلارنىڭ	oquʁut͡ʃilarniŋ
ئوقۇيالايدىغان	oqujalajdiʁan
ئولتۇراقلاشقان	olturaqlaʃqan
ئويلايدىغانسىز	ojlajdiʁansiz
ئويناۋاتقاندەك	ojnawatqandɛk
ئويۇنچۇقلىرىغۇ	ojunt͡ʃuqliriʁu
ئوڭايسىزلانغان	oŋajsizlanʁan
ئىزدەۋاتقاندەك	izdɛwatqandɛk
ئىشلىگەنلىكىنى	iʃliɡɛnlikini
ئىشلەتمەيدىكەن	iʃlɛtmɛjdikɛn
ئىشلەمچىلەردىن	iʃlɛmt͡ʃilɛrdin
ئىشلەۋاتقاندەك	iʃlɛwatqandɛk
ئىشلەۋېرىدىكەن	iʃlɛweridikɛn
ئىلگىرىلىمەكتە	ilɡirilimɛktɛ
ئۆتكۈزىۋېتەتتى	øtkyziwetɛtti
ئۆتكۈزۈلگەندەك	øtkyzylɡɛndɛk
ئۆسۈملۈكلەرنىڭ	øsymlyklɛrniŋ
ئۆلتۈرۈۋېتىپتۇ	øltyrywetiptu
ئۆلمىگەنلىكىنى	ølmiɡɛnlikini
ئۇيغۇرچىسىنىمۇ	ujʁurt͡ʃisinimu
ئۇچرىشىشلىرىدا	ut͡ʃriʃiʃlirida
ئۇچقۇچىلىرىنىڭ	ut͡ʃqut͡ʃiliriniŋ
ئېتىز–ئېرىقنىڭ	etiz–eriqniŋ
ئېزىشلىرىمىزمۇ	eziʃlirimizmu
ئېيتقانلارنىلا	ejtqanlarnila
ئېيتىۋاتقاندەك	ejtiwatqandɛk
ئەتراپىمىزدىكى	ɛtrapimizdiki
ئەترىتىدىكىلەر	ɛtritidikilɛr
ئەسقاتمايدىغان	ɛsqatmajdiʁan
ئەكىرگەنكەنمەن	ɛkirɡɛnkɛnmɛn
ئەكەلگەنلىكىنى	ɛkɛlɡɛnlikini
ئەگەشتۈرۋالغان	ɛɡɛʃtyrwalʁan
باقماپتىكەنمەن	baqmaptikɛnmɛn
باكتېرىيىلەرنى	bakterijilɛrni
بايقىغانلىقىنى	bajqiʁanliqini
بوغۇزلانغاندىن	boʁuzlanʁandin
بولىدىغانلىقنى	bolidiʁanliqni
بىلدۈرمەكچىكەن	bildyrmɛkt͡ʃikɛn
بېرىۋەتمەسلىكى	beriwɛtmɛsliki
بېقىۋېتىپتىمىز	beqiwetiptimiz
تارقىتىۋېتىپتۇ	tarqitiwetiptu
تاشلىۋېتىدىغان	taʃliwetidiʁan
تاشلىۋەتكەندەك	taʃliwɛtkɛndɛk
تاقەتسىزلەنگەن	taqɛtsizlɛnɡɛn
تالىشىۋاتقۇدەك	taliʃiwatqudɛk
تاپشۇرۇۋاتاتتى	tapʃuruwatatti
تاپشۇرۇۋالاتتى	tapʃuruwalatti
توقۇمىچىلارنىڭ	toqumit͡ʃilarniŋ
تېمپېراتۇرسىغا	temperatursiʁa
تەبرىكلىگەنلەر	tɛbrikliɡɛnlɛr
تەشكىللىگۈچىسى	tɛʃkilliɡyt͡ʃisi
تەمىنلىيەلەتتى	tɛminlijɛlɛtti
جەزملەشتۈرۈپتۈ	d͡ʒɛzmlɛʃtyrypty
خەۋەرلەندۈرگەن	χɛwɛrlɛndyrɡɛn
داۋالىيالايمىز	dawalijalajmiz
دوختۇرخانىسىغا	doχturχanisiʁa
دوختۇرخانىغىمۇ	doχturχaniʁimu
دىھقانچىلىقتىن	dihqant͡ʃiliqtin
رىقابەتلىشىشكە	riqabɛtliʃiʃkɛ
رىۋايەتلەردىكى	riwajɛtlɛrdiki
ساتمىغانلىقىنى	satmiʁanliqini
ساڭگىلاتقىنىچە	saŋɡilatqinit͡ʃɛ
ساۋاقداشلاردىن	sawaqdaʃlardin
ساۋاقداشلارنىڭ	sawaqdaʃlarniŋ
ساۋاقداشلىرىنى	sawaqdaʃlirini
سوپىسوپىياڭنىڭ	sopisopijaŋniŋ
سۇندۇرۇۋېتىپتۇ	sunduruwetiptu
شارىنىڭكىدىنمۇ	ʃariniŋkidinmu
شالغۇتلاشتۇرۇپ	ʃalʁutlaʃturup
شىۋېتسارىيىنىڭ	ʃiwetsarijiniŋ
قاراۋاتقىنىمدا	qarawatqinimda
قاماشتۇرىدىغان	qamaʃturidiʁan
قايتالمايدىغان	qajtalmajdiʁan
قىزلارنىڭكىدەك	qizlarniŋkidɛk
قىستۇرىۋېتەتتى	qisturiwetɛtti
قىلىنغانلىقىنى	qilinʁanliqini
قىلىۋالالايسەن	qiliwalalajsɛn
قىيالمىغىنىدىن	qijalmiʁinidin
قېلىشلىرىمىزمۇ	qeliʃlirimizmu
قەلەمتىرىچىڭىز	qɛlɛmtirit͡ʃiŋiz
كوماندىروپكىغا	komandiropkiʁa
كىرگۈزۈلمەيتتى	kirɡyzylmɛjtti
كىرگۈزۈۋېتىشنى	kirɡyzywetiʃni
كىيمىگەنلىكىنى	kijmiɡɛnlikini
كىيگۈزۈۋېتىپتۇ	kijɡyzywetiptu
كۆتۈرۈلگەنسېرى	køtyrylɡɛnseri
كۆتۈرۈلۈۋاتقان	køtyrylywatqan
كۆرسىتىۋېرىپتۇ	kørsitiweriptu
كۆرمىگەنلىكىنى	kørmiɡɛnlikini
كۆرگەزمىخانىدا	kørɡɛzmiχanida
كۆرەلمىگىنىمنى	kørɛlmiɡinimni
كۆپۈكچىلىرىنىڭ	køpykt͡ʃiliriniŋ
كۆڭۈلسىزلىكنىڭ	køŋylsizlikniŋ
كۈلكە–پاراڭلار	kylkɛ–paraŋlar
كېتىشلىرىمىزمۇ	ketiʃlirimizmu
كېسەللىكلەرنىڭ	kesɛlliklɛrniŋ
كەتكەنلىكىنىمۇ	kɛtkɛnlikinimu
كەتمىگەنلىكىنى	kɛtmiɡɛnlikini
كەشپىياتلىرىنى	kɛʃpijatlirini
كەلمىگەنلىكىنى	kɛlmiɡɛnlikini
ماتىرىياللارنى	matirijallarni
مارجانبۇلاقنىڭ	mard͡ʒanbulaqniŋ
ماڭىدىغاندىمەن	maŋidiʁandimɛn
مىننەتدارلىقىم	minnɛtdarliqim
مۆلچەرلىنىشىچە	mølt͡ʃɛrliniʃit͡ʃɛ
مۆلچەرلەنمەكتە	mølt͡ʃɛrlɛnmɛktɛ
مۇداپىئىلەنسەڭ	mudapiilɛnsɛŋ
مۇكەممەللىشىدۇ	mukɛmmɛlliʃidu
مېخانىزىملارنى	meχanizimlarni
مەركەزلەشتۈرۈپ	mɛrkɛzlɛʃtyryp
مەھەللىمىزدىكى	mɛhɛllimizdiki
مەھەللىڭىزدىما	mɛhɛlliŋizdima
مەۋجۇتلۇقۇڭدەك	mɛwd͡ʒutluquŋdɛk
مەۋجۇتلۇقۇڭنىڭ	mɛwd͡ʒutluquŋniŋ
ناخشا–مۇزىكىغا	naχʃa–muzikiʁa
نازارەتچىلىككە	nazarɛtt͡ʃilikkɛ
ياراشقانلىقىنى	jaraʃqanliqini
ياردەملەشمىگەن	jardɛmlɛʃmiɡɛn
ياسىغۇچىلارنىڭ	jasiʁut͡ʃilarniŋ
ياسىيالايدىغان	jasijalajdiʁan
ياقتۇرمايدىكەن	jaqturmajdikɛn
ياقمىغانلىقىنى	jaqmiʁanliqini
ياندۇرىدىغانغا	janduridiʁanʁa
يوپۇرماقلاردىن	jopurmaqlardin
يوپۇرماقلىرىنى	jopurmaqlirini
يىغلىغانلىقىنى	jiʁliʁanliqini
يۇرتداشلىرىدىن	jurtdaʃliridin
يۇپۇرماقلىرىنى	jupurmaqlirini
يۈگۈرگىنىمىزچە	jyɡyrɡinimizt͡ʃɛ
يۈگۈرەلەيدىكەن	jyɡyrɛlɛjdikɛn
يېڭىلگەنلىكىگە	jeŋilɡɛnlikiɡɛ
يەتمىگەنلىكىنى	jɛtmiɡɛnlikini
يەۋاتقانلىقىنى	jɛwatqanliqini
پادىشاھلىقىمدا	padiʃahliqimda
پونكىتلىرىنىمۇ	ponkitlirinimu
چاڭگاللىغىنىچە	t͡ʃaŋɡalliʁinit͡ʃɛ
چىرمىۋالغاندەك	t͡ʃirmiwalʁandɛk
چىقارغانلىقىغا	t͡ʃiqarʁanliqiʁa
چۈمكىۋالغانىدى	t͡ʃymkiwalʁanidi
چەۋەندازلاردىن	t͡ʃɛwɛndazlardin
چەۋەندازلىرىنى	t͡ʃɛwɛndazlirini
گۈزەللىكلىرىنى	ɡyzɛlliklirini
ھاياجانلىنىشتى	hajad͡ʒanliniʃti
ھەركەتلەندۈرۈش	hɛrkɛtlɛndyryʃ
ھەركەتلەندۈرۈپ	hɛrkɛtlɛndyryp
ھەيدەكچىلىكىدە	hɛjdɛkt͡ʃilikidɛ
ۋارقىرېۋىتىپتۇ	warqirewitiptu
ۋېلىسىپىتىمدىن	welisipitimdin
‹‹ئەدەپ–ئەخلاق	‹‹ɛdɛp–ɛχlaq
ئائىلىسىدىكىلەر	ailisidikilɛr
ئابرۇي–ئىناۋىتى	abruj–inawiti
ئاتا–ئانىسىنىمۇ	ata–anisinimu
ئازابلىنىۋاتقان	azabliniwatqan
ئالاھىدىلىكلىرى	alahidilikliri
ئالىدىغانلىقىنى	alidiʁanliqini
ئايلاندۇرالايدۇ	ajlanduralajdu
ئاپپاراتلاردىكى	apparatlardiki
ئاڭلىمىغانمىدىڭ	aŋlimiʁanmidiŋ
ئورۇنلاشتۇرۇشقا	orunlaʃturuʃqa
ئولاشتۇرالمىغان	olaʃturalmiʁan
ئونىۋېرستېتىنىڭ	oniwerstetiniŋ
ئىتتىرىشىۋاتقان	ittiriʃiwatqan
ئىستىرېلكىسىنىڭ	istirelkisiniŋ
ئۆپكە–ئۆپكىسىنى	øpkɛ–øpkisini
ئۆگىنىۋېلىشىمىز	øɡiniweliʃimiz
ئۇرۇلۇۋاتقاندەك	uruluwatqandɛk
ئۇنىۋېرسىتېتىدا	uniwersitetida
ئېلانلىرىمىزنىڭ	elanlirimizniŋ
ئەمەلىيلەشتۈرۈش	ɛmɛlijlɛʃtyryʃ
بايقىۋالالايسىز	bajqiwalalajsiz
بولىدىغانلىقىنى	bolidiʁanliqini
بىلەلمەيۋاتىمەن	bilɛlmɛjwatimɛn
تاتسۇنوكۇچىدىكى	tatsunokut͡ʃidiki
تارقىتالايدىغان	tarqitalajdiʁan
تاقلىيالايدىكەن	taqlijalajdikɛn
تۆكۈلۈۋاتقاندەك	tøkylywatqandɛk
تۇرالمىغىدەكمەن	turalmiʁidɛkmɛn
تۈگىتەلمەيدىغان	tyɡitɛlmɛjdiʁan
داۋاملاشتۇرۇپتۇ	dawamlaʃturuptu
دېيەلمىگۈدەكمەن	dejɛlmiɡydɛkmɛn
ساۋاقداشلىرىنىڭ	sawaqdaʃliriniŋ
سۆزلەنگەنلىكىنى	søzlɛnɡɛnlikini
سەتلەشتۈرۈۋەتتى	sɛtlɛʃtyrywɛtti
شەكىللىنەلمەيدۇ	ʃɛkillinɛlmɛjdu
قاتناشقانلىقىنى	qatnaʃqanliqini
قاراخانىيلارنىڭ	qaraχanijlarniŋ
قالىدىغانلىقىنى	qalidiʁanliqini
قانۇنىيەتلىكتەك	qanunijɛtliktɛk
قوغدىيالايدىغان	qoʁdijalajdiʁan
قوغلاۋاتامدىكىن	qoʁlawatamdikin
قىزغىنلىقىمىزنى	qizʁinliqimizni
قىزىقارلىقمىكەن	qiziqarliqmikɛn
قىزىققۇچىلارنىڭ	qiziqqut͡ʃilarniŋ
قىيىنلاشماقتىدى	qijinlaʃmaqtidi
قېرىنداشلىرىڭنى	qerindaʃliriŋni
قەبرىستانلىقتەك	qɛbristanliqtɛk
كۆرسەتكەنلىرىگە	kørsɛtkɛnliriɡɛ
كۆرمەيۋاتىمەنغۇ	kørmɛjwatimɛnʁu
كېتىدىغانلىقىنى	ketidiʁanliqini
كېلىدىغانلاردىن	kelidiʁanlardin
كېلىدىغانلىقىنى	kelidiʁanliqini
كەشتىلەنگەنىكەن	kɛʃtilɛnɡɛnikɛn
كەشپىياتلىرىدىن	kɛʃpijatliridin
مارجانبۇلىقىمىز	mard͡ʒanbuliqimiz
ماڭىدىغانلىقىنى	maŋidiʁanliqini
مۇداپىئىلىنىمەن	mudapiilinimɛn
مۇشەققەتلىرىنىڭ	muʃɛqqɛtliriniŋ
يېمەك–ئېچمەكلەر	jemɛk–et͡ʃmɛklɛr
يېپىشتۇرۇۋەتتىم	jepiʃturuwɛttim
پائالىيەتلىرىگە	paalijɛtliriɡɛ
چىقىدىغانلىقىنى	t͡ʃiqidiʁanliqini
چۈشىدىغانلىقىغا	t͡ʃyʃidiʁanliqiʁa
گۇمانلانمايتتىڭ	ɡumanlanmajttiŋ
ھاسىراپ–ھۆمۈدەپ	hasirap–hømydɛp
ھېسىسىياتىمىزنى	hesisijatimizni
ھەركەتلىنىدىغان	hɛrkɛtlinidiʁan
ئوقۇتقۇچىلىرىمىز	oqutqut͡ʃilirimiz
ئوقۇتقۇچىلىرىنىڭ	oqutqut͡ʃiliriniŋ
ئوقۇۋاتقانلارنىڭ	oquwatqanlarniŋ
ئويلاندۇرىدىغىنى	ojlanduridiʁini
ئويلىنىۋالغاندىن	ojliniwalʁandin
ئويناۋاتقاندەكلا	ojnawatqandɛkla
ئۆتىۋاتقىنىمىزغا	øtiwatqinimizʁa
ئۆسىدىغانلىقىدىن	øsidiʁanliqidin
ئۇنىۋېرسىتېتىنىڭ	uniwersitetiniŋ
ئۇنىۋېرىستېتىدىن	uniweristetidin
ئۇچۇرۇۋاتقانىكەن	ut͡ʃuruwatqanikɛn
ئېلىۋاتقانلىقىنى	eliwatqanliqini
ئەتراپىدىكىلەرگە	ɛtrapidikilɛrɡɛ
باشلانغانلىقىدىن	baʃlanʁanliqidin
باغلىغانلقىمىزغا	baʁliʁanlqimizʁa
بولىدىغانلىرىنىڭ	bolidiʁanliriniŋ
بولىۋاتقانلىقىنى	boliwatqanliqini
تونۇۋالغانلىقىغا	tonuwalʁanliqiʁa
تۇغقانلىرىمىزنىڭ	tuʁqanlirimizniŋ
تېرىيدىغانلاردىن	terijdiʁanlardin
جانلاندۇرۇۋېتىدۇ	d͡ʒanlanduruwetidu
خالايدىغانلارنىڭ	χalajdiʁanlarniŋ
خەۋپكەيولۇققاندا	χɛwpkɛjoluqqanda
دارىلفۇنۇنلىرىغا	darilfununliriʁa
زىننەتلىنىۋالغان	zinnɛtliniwalʁan
سورۇۋاتقانلققىنى	soruwatqanlqqini
سېپىۋاتقانلىقىنى	sepiwatqanliqini
سەتلەشتۈرۈۋەتتىم	sɛtlɛʃtyrywɛttim
قاچىلىيالايدىغان	qat͡ʃilijalajdiʁan
قولۇم–قوشنىلىرىم	qolum–qoʃnilirim
قىلغانلىقىمدىنمۇ	qilʁanliqimdinmu
قىلىۋاتقانلىقىنى	qiliwatqanliqini
قۇتقۇزىۋېلىنمىسا	qutquziwelinmisa
قېزىۋاتقانلاردىن	qeziwatqanlardin
قېلىشمايدىكەنسىز	qeliʃmajdikɛnsiz
كۆرىدىغانلىقىمنى	køridiʁanliqimni
كېلىۋاتقانلىقىنى	keliwatqanliqini
كېلەلمەيدىكەنمەن	kelɛlmɛjdikɛnmɛn
كەشپىياتچىمىزنىڭ	kɛʃpijatt͡ʃimizniŋ
مۇئەييەنلەشتۈردى	muɛjjɛnlɛʃtyrdi
مۇتەخەسىسسلەرنىڭ	mutɛχɛsisslɛrniŋ
مۇكەممەللەشتۈرۈش	mukɛmmɛllɛʃtyryʃ
مۇكەممەللەشتۈرۈپ	mukɛmmɛllɛʃtyryp
مۇۋەپپەقىيەتلىرى	muwɛppɛqijɛtliri
مەدەنىيىتىمىزنىڭ	mɛdɛnijitimizniŋ
مەسلىھەتلىرىنىمۇ	mɛslihɛtlirinimu
ياساۋاتقانلىقىنى	jasawatqanliqini
يېتەرسىزلىكىنىنى	jetɛrsizlikinini
يېقىنلاشقانلارنى	jeqinlaʃqanlarni
پائالىيىتىمىزدىن	paalijitimizdin
پائالىيەتلىرىدىن	paalijɛtliridin
پۇشىشى–ۋودىتسىغا	puʃiʃi–woditsiʁa
چىقىدىغانلىقىمنى	t͡ʃiqidiʁanliqimni
چۆرگىلىتەلمەيتتى	t͡ʃørɡilitɛlmɛjtti
چۇۋۇرلىشىۋاتىمىز	t͡ʃuwurliʃiwatimiz
چۈشۈۋاتقانلىقىنى	t͡ʃyʃywatqanliqini
ھاردۇرۇۋېتىدىغان	harduruwetidiʁan
ھەقەمسايىلىرىمىز	hɛqɛmsajilirimiz
ئائىلەمدىكىلەرنىڭ	ailɛmdikilɛrniŋ
ئالدىراۋاتقانلىقى	aldirawatqanliqi
ئايدىڭلاشتۇرماقچى	ajdiŋlaʃturmaqt͡ʃi
ئاۋارىچىلىقلاردىن	awarit͡ʃiliqlardin
ئىشلەيدىغانلىقىنى	iʃlɛjdiʁanliqini
ئىشىك–دېرىزلەرنىڭ	iʃik–derizlɛrniŋ
ئىلھاملاندۇراتتىڭ	ilhamlandurattiŋ
ئۆرپ–ئادەتلىرىنىڭ	ørp–adɛtliriniŋ
ئۇنىۋېرسىتېتىدىكى	uniwersitetidiki
ئەترىتىدىكىلەردىن	ɛtritidikilɛrdin
ئەقىدىلەشتۈرۈلگەن	ɛqidilɛʃtyrylɡɛn
تارتىۋاتقانلىقىنى	tartiwatqanliqini
تۆلىنىدىغانلىقىنى	tølinidiʁanliqini
تەبرىكلەيدىغانلار	tɛbriklɛjdiʁanlar
سايراۋاتقانلىقىنى	sajrawatqanliqini
سورىۋالمىغاندىمەن	soriwalmiʁandimɛn
كاپالەتلەندۈرگۈچى	kapalɛtlɛndyrɡyt͡ʃi
كېتىۋاتقانلىقىڭنى	ketiwatqanliqiŋni
كەلمەيدىغانلىقىنى	kɛlmɛjdiʁanliqini
كەچۈرۈدىغانلىقىنى	kɛt͡ʃyrydiʁanliqini
يىغلاۋاتقانلىقىغا	jiʁlawatqanliqiʁa
پائالىيەتلىرىدىلا	paalijɛtliridila
چۈشىنىۋېلىشقانىدى	t͡ʃyʃiniweliʃqanidi
چۈشەنمىگەنىكەنمەن	t͡ʃyʃɛnmiɡɛnikɛnmɛn
ئايلاندۇرالايدىكەن	ajlanduralajdikɛn
ئوخشايدىغانلىقىمنى	oχʃajdiʁanliqimni
ئىپادىيەلىسەڭلارلا	ipadijɛlisɛŋlarla
ئەۋلاتلىرىمىزدىنمۇ	ɛwlatlirimizdinmu
بارىدىغانلىقىدىنغۇ	baridiʁanliqidinʁu
تىرىشچانلىقلىرىمنى	tiriʃt͡ʃanliqlirimni
جاپا–مۇشەققەتلەرگە	d͡ʒapa–muʃɛqqɛtlɛrɡɛ
قورقمايدىغانلىقىغا	qorqmajdiʁanliqiʁa
قېرىنداشلىرىمىزنىڭ	qerindaʃlirimizniŋ
مۇزدەكلىكىدىنمىكىن	muzdɛklikidinmikin
ياندۇرغۇزۇۋاتاتتىم	jandurʁuzuwatattim
ئايرىلمايۋاتقانىكەن	ajrilmajwatqanikɛn
ئايلىنىۋاتقانلىقىنى	ajliniwatqanliqini
قانائەتلەنگەنلىكىنى	qanaɛtlɛnɡɛnlikini
قىلالايدىغانلىقىمىز	qilalajdiʁanliqimiz
كۆرەلمەيدىغانلىقىنى	kørɛlmɛjdiʁanliqini
توقۇيالايدىغانلىقىنى	toqujalajdiʁanliqini
ئازاپلىنىۋاتقانلىقىنى	azapliniwatqanliqini
ئاپىرىۋېتىدىغانلىقىنى	apiriwetidiʁanliqini
ئەكسىلئىنقىلابچىلارنى	ɛksilinqilabt͡ʃilarni
داۋاملاشتۇرىۋېرىدىكەن	dawamlaʃturiweridikɛn
مەسلىھەتلىشىۋالغاندەك	mɛslihɛtliʃiwalʁandɛk
چۇرقىرىشىۋاتقانلىقىنى	t͡ʃurqiriʃiwatqanliqini
